1
1
15
0
(8 0
((0,0,0) (7,7,7) (0,0,0))
((8,0,0) (15,7,7) (0,0,0))
((0,8,0) (7,15,7) (0,0,0))
((8,8,0) (15,15,7) (0,0,0))
((0,0,8) (7,7,15) (0,0,0))
((8,0,8) (15,7,15) (0,0,0))
((0,8,8) (7,15,15) (0,0,0))
((8,8,8) (15,15,15) (0,0,0))
)
8
FabOnDisk: Cell_D_00000 0
FabOnDisk: Cell_D_00000 61527
FabOnDisk: Cell_D_00000 123055
FabOnDisk: Cell_D_00000 184583
FabOnDisk: Cell_D_00000 246112
FabOnDisk: Cell_D_00000 307640
FabOnDisk: Cell_D_00000 369169
FabOnDisk: Cell_D_00000 430698

8,15
1.23389019844440794e-02,4.16310703320858164e-02,-1.38432591965964476e-02,-1.40761883751218328e-02,-9.01729205796921937e-03,6.29076821350768811e-01,-2.46656594526355882e-03,-8.53824109100114999e-04,3.16082222922249643e-04,-1.03232211180572051e-02,-3.52864431856471789e-02,-1.18399328820643773e-01,-3.64138649108351031e-01,-4.10174037488130916e-01,-4.52502890161829152e-01,
1.21105549142356151e-02,1.70757411466627151e-02,-1.01297077730176203e-02,-1.41946343355940779e-02,-8.96458626094906452e-03,6.28880267937599879e-01,-9.72827565342510373e-03,-1.02554450362064885e-03,-5.05829295401667820e-04,-3.64577202609631279e-01,-4.60472738288661768e-02,-1.49353443174788159e-01,-8.25494488473502985e-02,-4.58792775479384796e-01,-5.17517867869921711e-01,
1.21004773643610813e-02,6.35729885650481493e-03,-1.32766198345153370e-02,-9.30089293268943421e-03,-7.97870163544726896e-03,6.28334711462690487e-01,-7.07320328549028605e-03,-9.02041378305338398e-03,-5.57754791812846290e-02,-1.72909178278964522e-02,-4.06454459749651220e-01,-1.87551575389590663e-01,-4.46752422222054080e-01,-1.68513987572017965e-01,-5.67995332775916073e-01,
1.21236531389096996e-02,1.97800991509209908e-03,-1.49098087457234848e-02,-1.26276504137518373e-02,-1.53836645132175882e-02,6.28160674568260191e-01,-2.85392350914823838e-02,-5.08058130157080096e-02,-7.81462290175224394e-02,-4.35697085428850939e-01,-4.15569593604385501e-01,-2.31876468032018890e-01,-8.50831334450325993e-02,-1.69390119702806596e-01,-5.93084905865163714e-01,
1.21717139488511737e-02,1.64615525315592250e-03,-1.28233965744886241e-02,-1.37123978822680306e-02,-8.76958494547314463e-03,6.29317927983140457e-01,-1.17178639531211638e-02,-4.71265561542334455e-02,-8.62667722671012216e-03,-2.31064742778760053e-02,-8.11846458765142776e-02,-4.44456333681416682e-01,-5.23375591012394281e-01,-5.35659600163880145e-01,-2.69575695224447076e-01,
1.21840928460793512e-02,1.74984578574200082e-05,-1.39749386109570290e-02,-1.33373881818488020e-02,-9.38459628513228089e-03,6.28644025929889327e-01,-4.22567117433834905e-01,-8.60673693514709126e-01,-8.25950792922048094e-01,-4.63790807533765226e-01,-1.03874264576550204e-01,-4.60608815252594783e-01,-8.48702168562407017e-02,-6.02255926078590242e-01,-2.70787165063694935e-01,
1.22805392355752920e-02,-4.19047100548496153e-04,-1.49000362293681323e-02,-9.59091894284442442e-03,-7.97388449047884210e-03,6.28838258466599798e-01,-1.11896261342014691e+00,-2.12493814461851116e-01,-1.68911137450621675e-02,-3.79937029457768777e-02,-4.82474873216456546e-01,-4.61536307740258778e-01,-5.73883558613325295e-01,-1.72574091695184895e-01,-2.71085702825290653e-01,
1.23916311326246840e-02,-2.29120597335417129e-03,-1.46825327702295449e-02,-1.16033341821335009e-02,-1.14044500763705575e-02,6.28048443180676541e-01,-1.04527806884612362e+00,-1.34181717782031806e-01,-1.41126495504488303e-01,-4.69606586724323316e-01,-5.08262765643571757e-01,-4.82254058921005702e-01,-8.85710516600804049e-02,-1.75683640527222767e-01,-2.72551119442159151e-01,

8,15
8.48467798018309516e-01,1.05527804379734014e+00,1.46744213869864828e-02,1.63421056594110076e-02,1.94126801959609296e-02,1.06762050853918122e+00,1.18829047766817776e-02,1.23805161821552885e-02,9.92973804121874415e-03,3.68684870344150650e-01,4.10102855733938010e-01,4.38904491927251617e-01,1.09682310034124987e-03,4.00926144213985605e-03,1.73680707329765781e-02,
9.92953584624685526e-01,1.05617073435714337e+00,1.86925609369935908e-02,1.99707391016496656e-02,2.21013726741637051e-02,1.06829692610390770e+00,6.62934518030308065e-03,2.75217931671545395e-02,1.72624516135818223e-02,5.39505197966413802e-02,4.22524309673747933e-01,4.68234062306194243e-01,3.61364471493419548e-01,5.54283586728473825e-03,2.43360688584861873e-02,
1.11529249922480145e+00,1.05605373963121019e+00,1.87849387635147212e-02,2.21035990753312150e-02,2.06215375458429703e-02,1.12164979808130627e+00,1.55952125772286111e-02,8.84922782939166763e-03,1.35600693622092185e-02,4.35079117911265023e-01,1.07087537654485379e-01,4.83926498641882308e-01,2.03428523337690704e-03,4.10413836414456945e-01,3.36866455928976211e-02,
1.20275618190852152e+00,1.05508542285507367e+00,1.84719415786671233e-02,2.23646894354610701e-02,2.28616362275880156e-02,1.20473419182361363e+00,3.84392866670804217e-02,3.03506241009249313e-02,3.06868789486191527e-02,5.50031142383974186e-02,1.09244681670347787e-01,4.85970817669048982e-01,4.49751133579116669e-01,4.55899711659511042e-01,4.68216558429404711e-02,
1.22271611025323512e+00,1.05578128877067945e+00,1.82461821680605651e-02,1.73843609281015693e-02,2.25488474396449527e-02,1.22436226550639105e+00,3.01040789568786417e-02,1.43052376908587645e-02,1.72827876898366609e-02,4.64926487139154077e-01,4.77512982453738577e-01,1.70969986077579211e-01,2.85671539294686744e-03,1.06545976203766771e-02,4.73112427566819926e-01,
1.26625307273077659e+00,1.05501591430314079e+00,1.83128497419775757e-02,1.82236400482890110e-02,2.28542329639427125e-02,1.26627057118863395e+00,2.50956695140215014e-01,4.61048049573762442e-01,2.24754541792384244e-01,5.45754515653915917e-02,5.08099236491499351e-01,1.71555355892344941e-01,5.25688585605447067e-01,1.47673783232004571e-02,5.25788247281170351e-01,
1.28200027770046665e+00,1.05432087213407510e+00,1.90113316388137027e-02,2.23746094027334648e-02,2.26885958488881011e-02,1.28158123059991813e+00,6.62027095311574998e-01,4.31636962839368366e-01,1.11280733879421811e+00,4.72257623541934457e-01,1.10163053884649059e-01,1.73234377551034380e-01,5.30471377933244923e-03,5.45734475647203787e-01,5.54285573960435318e-01,
1.29401434500151225e+00,1.05279521674488996e+00,1.92575087251441526e-02,2.32026940420622732e-02,2.40985759380545408e-02,1.29316790076352817e+00,5.44597518148546733e-01,6.50514625526594337e+00,8.63430149304132932e+00,5.55189747011733750e-02,1.11485381784915918e-01,1.73405692788935584e-01,5.69165136527444160e-01,6.06886518321872126e-01,5.58883094031201955e-01,

