1
1
15
0
(8 0
((0,0,0) (7,7,7) (0,0,0))
((8,0,0) (15,7,7) (0,0,0))
((0,8,0) (7,15,7) (0,0,0))
((8,8,0) (15,15,7) (0,0,0))
((0,0,8) (7,7,15) (0,0,0))
((8,0,8) (15,7,15) (0,0,0))
((0,8,8) (7,15,15) (0,0,0))
((8,8,8) (15,15,15) (0,0,0))
)
8
FabOnDisk: Cell_D_00000 0
FabOnDisk: Cell_D_00000 61527
FabOnDisk: Cell_D_00000 123055
FabOnDisk: Cell_D_00000 184583
FabOnDisk: Cell_D_00000 246112
FabOnDisk: Cell_D_00000 307640
FabOnDisk: Cell_D_00000 369169
FabOnDisk: Cell_D_00000 430698

8,15
1.23369374989707077e-02,4.48007625085772090e-02,-1.44785939217223943e-02,-1.43121364822267789e-02,-9.56969665033563510e-03,6.30637865233682371e-01,-2.48975375820005909e-03,-8.77552918893969138e-04,5.23446034791360225e-04,-9.70737344779561487e-03,-3.56601851142572257e-02,-1.22593378059137850e-01,-3.60011731359412668e-01,-4.06252115119218216e-01,-4.47316711348533236e-01,
1.21124311695588963e-02,1.92264235098333937e-02,-9.86681192255259645e-03,-1.42593505584330746e-02,-9.22960804249484817e-03,6.29980010825471393e-01,-9.04571912315465382e-03,-1.20703643079061334e-03,-2.98462488782916366e-04,-3.64369426818090369e-01,-4.65185544677991572e-02,-1.55143377192914433e-01,-8.24274516427757065e-02,-4.56154071764605651e-01,-5.13354280445407207e-01,
1.21220250316120808e-02,6.56548523408209943e-03,-1.38244226523101289e-02,-9.22947282260685661e-03,-8.18019605257165258e-03,6.28432156108898687e-01,-1.85465803053079178e-03,-9.13363681988337353e-03,-3.15167045417493602e-02,-1.66976962168898964e-02,-4.05016215090663767e-01,-1.95020621229262614e-01,-4.42392442868157432e-01,-1.70544845055149219e-01,-5.68247456103114112e-01,
1.21521952351196956e-02,2.37617247609902974e-03,-1.47660610163112896e-02,-1.28413862771328390e-02,-1.18592010843881351e-02,6.27953783899654949e-01,-1.58949277473702660e-02,-9.20182181152497808e-03,-4.58408401458412496e-02,-4.33754550186679799e-01,-4.13973482945986015e-01,-2.41106856250168589e-01,-8.45838998411972964e-02,-1.71761910001102552e-01,-5.95980636260973862e-01,
1.21790615826849833e-02,1.71055891868121903e-03,-1.29947107464281706e-02,-1.38032768400369044e-02,-9.33971997556202679e-03,6.28943855423305553e-01,-2.85554836239144657e-03,-2.25755457720746497e-02,-8.11562607449890436e-03,-2.30571008712968095e-02,-8.37667735868564273e-02,-4.43641457632668601e-01,-5.22146441248920956e-01,-5.34016038207610455e-01,-2.73608738155525333e-01,
1.22060539204262176e-02,2.37747832243338954e-04,-1.39529875357574558e-02,-1.29906001950041636e-02,-9.37926014641397160e-03,6.28709298056104426e-01,-1.03257147645807512e-01,-2.38498459103536009e-01,-1.81771520542421267e-02,-4.62811728562485758e-01,-1.07581957021841923e-01,-4.57540957738995613e-01,-8.43533456704879947e-02,-6.01390452382764451e-01,-2.75490005563837959e-01,
1.22940106712851188e-02,-4.27519195782092697e-04,-1.37415503732187180e-02,-9.39697477413159454e-03,-8.60976275184698742e-03,6.27972490868350830e-01,-4.01785462778143554e+00,-2.46194077204645634e+00,-1.28176134884006622e-02,-3.87507782627247166e-02,-4.83943558472042734e-01,-4.58343307652844756e-01,-5.73678264362124546e-01,-1.75780450019813239e-01,-2.75427037695388011e-01,
1.23733796853739957e-02,-9.18908026600244649e-04,-1.62737952011853711e-02,-1.19264684008441278e-02,-1.26315815467269513e-02,6.27257180925124724e-01,-4.02899659306436231e-01,-1.45082915597025797e-01,-7.94726929400228044e-01,-4.70019842772985363e-01,-5.07984341423520669e-01,-4.86472732059321400e-01,-8.70750282054873204e-02,-1.77423410722596181e-01,-2.76720622156627905e-01,

8,15
8.33956942283966218e-01,1.05524135454958401e+00,1.40091796435361654e-02,1.61635074827639960e-02,1.90458221717064759e-02,1.06757829204855481e+00,1.14308382422074438e-02,1.30580055406171163e-02,1.02127195771030133e-02,3.68290996663052539e-01,4.09514014483239486e-01,4.36417760807892796e-01,1.07788027604613932e-03,4.07417228514350173e-03,1.80501598247062925e-02,
9.79516513046032267e-01,1.05618972989993942e+00,1.86165480123827651e-02,1.99502720023835498e-02,2.19433447737075633e-02,1.06831445395478353e+00,5.62626638349096250e-03,1.43194997500860708e-02,1.06730834645464394e-02,5.38160230819154928e-02,4.23772689867358943e-01,4.67674847347213318e-01,3.57408169004101162e-01,5.60959461787863614e-03,2.53488181535312142e-02,
1.10888449078939622e+00,1.05613999910646839e+00,1.85879500955178495e-02,2.22103816732579229e-02,2.00705671359965795e-02,1.11544997602347840e+00,1.57838259660559831e-02,9.63410415038954034e-03,1.44360875703407696e-02,4.33358211476038258e-01,1.08393805465176879e-01,4.86095428086874559e-01,1.98220186904715266e-03,4.07328894223133509e-01,3.54931641504607071e-02,
1.19878898074249052e+00,1.05577336823935197e+00,1.81697520633488339e-02,2.23549191231716682e-02,2.31147579807996391e-02,1.20116515321858963e+00,2.17301302692077709e-02,1.06371536496239864e-02,1.52702504720661925e-02,5.48401432685015969e-02,1.11027185704497017e-01,4.89058970027900330e-01,4.45116141646319463e-01,4.52698984370703772e-01,4.94661934667707942e-02,
1.22156492974901965e+00,1.05571056065753721e+00,1.80582703227852408e-02,1.67140277699310245e-02,2.24591552889327507e-02,1.22327548866770086e+00,2.18059612362335661e-02,1.40158247813224439e-02,1.84047619295991775e-02,4.64866283750711595e-01,4.76662213091779308e-01,1.73274019333824469e-01,2.80909039228026142e-03,1.10711299539596533e-02,4.72298863044360528e-01,
1.26421049522478390e+00,1.05532627885472197e+00,1.76017501572418786e-02,1.79931468492754813e-02,2.21377630086710547e-02,1.26444824305702719e+00,1.50335847919103649e-01,1.50765186696016767e-02,7.34573895304675289e-02,5.51379724391671128e-02,5.08126677693697903e-01,1.74214798034921070e-01,5.23092923015730848e-01,1.52935892582145103e-02,5.22459414325637805e-01,
1.28266833789066181e+00,1.05445585933770491e+00,1.95353107220765584e-02,2.23209510164090602e-02,2.27654435213458378e-02,1.28224081869487971e+00,8.60871998854089160e-02,1.28294273864414193e-01,9.28054779776727568e-01,4.72427936037055907e-01,1.12263712682775796e-01,1.75862896605090580e-01,5.23386043513855356e-03,5.48898613584281048e-01,5.50709602341368676e-01,
1.29159668142461870e+00,1.05314492136014604e+00,1.79361600353123984e-02,2.16663642241217355e-02,2.27869601045960976e-02,1.29080978214566255e+00,1.09789700281867675e+00,7.32855955977735896e-01,2.27914192658358061e+00,5.60896585008627824e-02,1.13299114601852075e-01,1.76613261703730817e-01,5.66763168863282818e-01,6.07521740271940613e-01,5.62773775500862383e-01,

