1
1
15
0
(8 0
((0,0,0) (7,7,7) (0,0,0))
((8,0,0) (15,7,7) (0,0,0))
((0,8,0) (7,15,7) (0,0,0))
((8,8,0) (15,15,7) (0,0,0))
((0,0,8) (7,7,15) (0,0,0))
((8,0,8) (15,7,15) (0,0,0))
((0,8,8) (7,15,15) (0,0,0))
((8,8,8) (15,15,15) (0,0,0))
)
8
FabOnDisk: Cell_D_00000 0
FabOnDisk: Cell_D_00000 61527
FabOnDisk: Cell_D_00000 123055
FabOnDisk: Cell_D_00000 184583
FabOnDisk: Cell_D_00000 246112
FabOnDisk: Cell_D_00000 307640
FabOnDisk: Cell_D_00000 369169
FabOnDisk: Cell_D_00000 430698

8,15
1.2336937498970708e-02,4.4800762508577209e-02,-1.4478593921722394e-02,-1.4312136482226779e-02,-9.5696966503356351e-03,6.3063786523368237e-01,-2.4897537582000591e-03,-8.7755291889396914e-04,5.2344603479136022e-04,-9.7073734477956149e-03,-3.5660185114257226e-02,-1.2259337805913785e-01,-3.6001173135941267e-01,-4.0625211511921822e-01,-4.4731671134853324e-01,
1.2112431169558896e-02,1.9226423509833394e-02,-9.8668119225525965e-03,-1.4259350558433075e-02,-9.2296080424948482e-03,6.2998001082547139e-01,-9.0457191231546538e-03,-1.2070364307906133e-03,-2.9846248878291637e-04,-3.6436942681809037e-01,-4.6518554467799157e-02,-1.5514337719291443e-01,-8.2427451642775706e-02,-4.5615407176460565e-01,-5.1335428044540721e-01,
1.2122025031612081e-02,6.5654852340820994e-03,-1.3824422652310129e-02,-9.2294728226068566e-03,-8.1801960525716526e-03,6.2843215610889869e-01,-1.8546580305307918e-03,-9.1336368198833735e-03,-3.1516704541749360e-02,-1.6697696216889896e-02,-4.0501621509066377e-01,-1.9502062122926261e-01,-4.4239244286815743e-01,-1.7054484505514922e-01,-5.6824745610311411e-01,
1.2152195235119696e-02,2.3761724760990297e-03,-1.4766061016311290e-02,-1.2841386277132839e-02,-1.1859201084388135e-02,6.2795378389965495e-01,-1.5894927747370266e-02,-9.2018218115249781e-03,-4.5840840145841250e-02,-4.3375455018667980e-01,-4.1397348294598602e-01,-2.4110685625016859e-01,-8.4583899841197296e-02,-1.7176191000110255e-01,-5.9598063626097386e-01,
1.2179061582684983e-02,1.7105589186812190e-03,-1.2994710746428171e-02,-1.3803276840036904e-02,-9.3397199755620268e-03,6.2894385542330555e-01,-2.8555483623914466e-03,-2.2575545772074650e-02,-8.1156260744989044e-03,-2.3057100871296810e-02,-8.3766773586856427e-02,-4.4364145763266860e-01,-5.2214644124892096e-01,-5.3401603820761046e-01,-2.7360873815552533e-01,
1.2206053920426218e-02,2.3774783224333895e-04,-1.3952987535757456e-02,-1.2990600195004164e-02,-9.3792601464139716e-03,6.2870929805610443e-01,-1.0325714764580751e-01,-2.3849845910353601e-01,-1.8177152054242127e-02,-4.6281172856248576e-01,-1.0758195702184192e-01,-4.5754095773899561e-01,-8.4353345670487995e-02,-6.0139045238276445e-01,-2.7549000556383796e-01,
1.2294010671285119e-02,-4.2751919578209270e-04,-1.3741550373218718e-02,-9.3969747741315945e-03,-8.6097627518469874e-03,6.2797249086835083e-01,-4.0178546277814355e+00,-2.4619407720464563e+00,-1.2817613488400662e-02,-3.8750778262724717e-02,-4.8394355847204273e-01,-4.5834330765284476e-01,-5.7367826436212455e-01,-1.7578045001981324e-01,-2.7542703769538801e-01,
1.2373379685373996e-02,-9.1890802660024465e-04,-1.6273795201185371e-02,-1.1926468400844128e-02,-1.2631581546726951e-02,6.2725718092512472e-01,-4.0289965930643623e-01,-1.4508291559702580e-01,-7.9472692940022804e-01,-4.7001984277298536e-01,-5.0798434142352067e-01,-4.8647273205932140e-01,-8.7075028205487320e-02,-1.7742341072259618e-01,-2.7672062215662790e-01,

8,15
8.3395694228396622e-01,1.0552413545495840e+00,1.4009179643536165e-02,1.6163507482763996e-02,1.9045822171706476e-02,1.0675782920485548e+00,1.1430838242207444e-02,1.3058005540617116e-02,1.0212719577103013e-02,3.6829099666305254e-01,4.0951401448323949e-01,4.3641776080789280e-01,1.0778802760461393e-03,4.0741722851435017e-03,1.8050159824706292e-02,
9.7951651304603227e-01,1.0561897298999394e+00,1.8616548012382765e-02,1.9950272002383550e-02,2.1943344773707563e-02,1.0683144539547835e+00,5.6262663834909625e-03,1.4319499750086071e-02,1.0673083464546439e-02,5.3816023081915493e-02,4.2377268986735894e-01,4.6767484734721332e-01,3.5740816900410116e-01,5.6095946178786361e-03,2.5348818153531214e-02,
1.1088844907893962e+00,1.0561399991064684e+00,1.8587950095517849e-02,2.2210381673257923e-02,2.0070567135996580e-02,1.1154499760234784e+00,1.5783825966055983e-02,9.6341041503895403e-03,1.4436087570340770e-02,4.3335821147603826e-01,1.0839380546517688e-01,4.8609542808687456e-01,1.9822018690471527e-03,4.0732889422313351e-01,3.5493164150460707e-02,
1.1987889807424905e+00,1.0557733682393520e+00,1.8169752063348834e-02,2.2354919123171668e-02,2.3114757980799639e-02,1.2011651532185896e+00,2.1730130269207771e-02,1.0637153649623986e-02,1.5270250472066193e-02,5.4840143268501597e-02,1.1102718570449702e-01,4.8905897002790033e-01,4.4511614164631946e-01,4.5269898437070377e-01,4.9466193466770794e-02,
1.2215649297490196e+00,1.0557105606575372e+00,1.8058270322785241e-02,1.6714027769931025e-02,2.2459155288932751e-02,1.2232754886677009e+00,2.1805961236233566e-02,1.4015824781322444e-02,1.8404761929599178e-02,4.6486628375071160e-01,4.7666221309177931e-01,1.7327401933382447e-01,2.8090903922802614e-03,1.1071129953959653e-02,4.7229886304436053e-01,
1.2642104952247839e+00,1.0553262788547220e+00,1.7601750157241879e-02,1.7993146849275481e-02,2.2137763008671055e-02,1.2644482430570272e+00,1.5033584791910365e-01,1.5076518669601677e-02,7.3457389530467529e-02,5.5137972439167113e-02,5.0812667769369790e-01,1.7421479803492107e-01,5.2309292301573085e-01,1.5293589258214510e-02,5.2245941432563781e-01,
1.2826683378906618e+00,1.0544558593377049e+00,1.9535310722076558e-02,2.2320951016409060e-02,2.2765443521345838e-02,1.2822408186948797e+00,8.6087199885408916e-02,1.2829427386441419e-01,9.2805477977672757e-01,4.7242793603705591e-01,1.1226371268277580e-01,1.7586289660509058e-01,5.2338604351385536e-03,5.4889861358428105e-01,5.5070960234136868e-01,
1.2915966814246187e+00,1.0531449213601460e+00,1.7936160035312398e-02,2.1666364224121736e-02,2.2786960104596098e-02,1.2908097821456626e+00,1.0978970028186767e+00,7.3285595597773590e-01,2.2791419265835806e+00,5.6089658500862782e-02,1.1329911460185207e-01,1.7661326170373082e-01,5.6676316886328282e-01,6.0752174027194061e-01,5.6277377550086238e-01,

