1
1
15
0
(8 0
((0,0,0) (7,7,7) (0,0,0))
((8,0,0) (15,7,7) (0,0,0))
((0,8,0) (7,15,7) (0,0,0))
((8,8,0) (15,15,7) (0,0,0))
((0,0,8) (7,7,15) (0,0,0))
((8,0,8) (15,7,15) (0,0,0))
((0,8,8) (7,15,15) (0,0,0))
((8,8,8) (15,15,15) (0,0,0))
)
8
FabOnDisk: Cell_D_00000 0
FabOnDisk: Cell_D_00000 61527
FabOnDisk: Cell_D_00000 123055
FabOnDisk: Cell_D_00000 184583
FabOnDisk: Cell_D_00000 246112
FabOnDisk: Cell_D_00000 307640
FabOnDisk: Cell_D_00000 369169
FabOnDisk: Cell_D_00000 430698

8,15
1.23820531809274593e-02,5.65634509300469296e-02,-1.56870744340980826e-02,-1.55625089114331591e-02,-1.27236325911536975e-02,6.35265194274367007e-01,-2.75793019354856391e-03,-2.13645758430022065e-03,-7.33252106190413985e-04,-9.59970449983408615e-03,-3.94479214496458730e-02,-1.25706912202074306e-01,-3.48907972789152476e-01,-3.93582513230516406e-01,-4.39688439503573669e-01,
1.21536420293325807e-02,2.44998214020487395e-02,-1.00379492257840208e-02,-1.57849953211867816e-02,-1.22280253165760779e-02,6.33973517138439302e-01,-8.06715232786421946e-03,-1.84809011301754773e-03,-1.52266666124039295e-03,-3.60640369843448827e-01,-5.20584610595599476e-02,-1.60607965341224235e-01,-8.82931983184841451e-02,-4.51395952675057333e-01,-4.99622746215589331e-01,
1.21547620087427231e-02,7.79857391088330156e-03,-1.36359799125953113e-02,-1.04241220422036755e-02,-1.14621140382766135e-02,6.28081874026588993e-01,-2.30761459249924274e-03,-1.06216608692140772e-02,-2.75053880154582271e-02,-1.71438208269375503e-02,-3.98905476521085101e-01,-2.05569939341070845e-01,-4.31426646205873010e-01,-1.81115154362059300e-01,-5.65320667585993863e-01,
1.21858618498681820e-02,2.63438188967976290e-03,-1.58504274547467613e-02,-1.45694948202031178e-02,-1.33732791178696568e-02,6.28060955329810655e-01,-1.49565421309528733e-02,-1.15949337626859335e-02,-4.78224278384399293e-02,-4.31276683378774561e-01,-4.05475801894566112e-01,-2.55534207312808181e-01,-8.89134146173150564e-02,-1.83515508642538627e-01,-6.00205519545734534e-01,
1.21894050590131853e-02,2.04866060002203759e-03,-1.41178634702787340e-02,-1.55826573735935881e-02,-1.22811092462950938e-02,6.28352738282200063e-01,-2.98671670390546033e-03,-2.82053723163924464e-02,-6.32087098898330597e-03,-2.34790127858463156e-02,-9.46691740693246242e-02,-4.38103932803880547e-01,-5.13606523715255836e-01,-5.18818269350527994e-01,-2.79015090757358475e-01,
1.22198822184624040e-02,3.95852204852327190e-04,-1.44990311845531062e-02,-1.47502231153975871e-02,-1.15925125219364343e-02,6.28905489595018352e-01,-7.87342079087949981e-02,-1.32388923228955235e-01,-2.37669212944579197e-02,-4.60141410678588658e-01,-1.22508894313231823e-01,-4.51821682772523436e-01,-8.94300938897991393e-02,-5.95576991240422182e-01,-2.82874726404235166e-01,
1.23181697164043511e-02,-4.32788934998618870e-04,-1.45501681491201334e-02,-1.11394113092150374e-02,-1.05484291062697116e-02,6.28421592282434216e-01,-3.48919511621652967e-01,-1.52682354262804187e-01,-4.08962687838207328e-01,-4.08592253720783255e-02,-4.86048889578911070e-01,-4.51885896043233593e-01,-5.78715166883959298e-01,-1.87758731138691348e-01,-2.81948497726816572e-01,
1.24126114551427087e-02,-7.98763276703532343e-04,-1.69010832380332432e-02,-1.20654787474313175e-02,-1.43525793309029082e-02,6.28736778813228980e-01,-1.67496442245922772e+00,-2.26463319235597760e-02,-2.66910833179308149e+00,-4.74006027178389133e-01,-5.05119422134272411e-01,-4.92631776813767908e-01,-9.08172660534265069e-02,-1.89765424155789786e-01,-2.82796057146587732e-01,

8,15
7.86517524747008201e-01,1.05505448706708527e+00,1.30031067022713664e-02,1.56160803187746777e-02,1.65613331232867325e-02,1.06743654024801282e+00,9.67442101793890806e-03,1.15095918266327774e-02,9.43756016997826866e-03,3.67840147319144273e-01,4.06015158992503733e-01,4.24499506321380560e-01,1.06497647285552798e-03,4.54053803020896055e-03,1.89101024649763090e-02,
9.43360951595821562e-01,1.05606123475303559e+00,1.86879433660693435e-02,1.82483763734683571e-02,2.01943941202704300e-02,1.06821487678236826e+00,5.11603859542365813e-03,1.44584795245720106e-02,9.75527975752002972e-03,5.66805946201014779e-02,4.27333624919546184e-01,4.61698810337927201e-01,3.45405488914122816e-01,6.35086054435979319e-03,2.69966097460603432e-02,
1.09093336010076647e+00,1.05604638799674677e+00,1.83434417568282340e-02,2.02224693049344595e-02,1.77621427610226874e-02,1.09873193401164970e+00,1.61320024556889652e-02,1.10160470568099189e-02,1.32634567227412487e-02,4.27889503460690268e-01,1.17340136202498030e-01,4.86852219096126915e-01,2.02958870031138367e-03,4.00124219582231211e-01,3.89975694963340391e-02,
1.19084385753800359e+00,1.05564487665836904e+00,1.69109959295231267e-02,2.04484465807538117e-02,2.08882216638978171e-02,1.19347823942768327e+00,2.02033579743794642e-02,1.17518731012807125e-02,1.33389012832013029e-02,5.74357039973582700e-02,1.18853348317041141e-01,4.92089152207093650e-01,4.39971505554649589e-01,4.45225909073913739e-01,5.51815838745270820e-02,
1.20979725979189823e+00,1.05576855140382175e+00,1.74596950230967995e-02,1.58578737232043902e-02,2.12269676169319077e-02,1.21184592039192029e+00,1.93825453671435631e-02,1.30581550349268168e-02,1.16128320178302928e-02,4.63266319843365804e-01,4.67394928839405366e-01,1.78605978917319552e-01,2.84828524306860809e-03,1.28248639794636583e-02,4.62414404846181459e-01,
1.25999802087775947e+00,1.05537372322421619e+00,1.71989640698429827e-02,1.63664600666511700e-02,2.06306290229286773e-02,1.26039387308261186e+00,9.79911012001157822e-02,1.26287342166180871e-02,4.79685807812326170e-02,5.77453116013708426e-02,5.05784518492899182e-01,1.78581255821487761e-01,5.16490186223770964e-01,1.80177031795654488e-02,5.14359089708611772e-01,
1.28217021080135196e+00,1.05445673572207310e+00,1.89450647111420317e-02,2.05927718113401402e-02,2.09677880566351282e-02,1.28173742186635331e+00,5.61153868757549162e-02,4.02527332869143176e-02,4.89072781761274888e-01,4.75106018690700016e-01,1.19894387649902318e-01,1.79321830020000267e-01,5.51666021708946581e-03,5.54597443938392831e-01,5.42663491464333347e-01,
1.29142032249616956e+00,1.05290796867289127e+00,1.82193807458850901e-02,1.98825421073980865e-02,2.12158076867144246e-02,1.29062155921946609e+00,1.28098263550996377e-01,1.25036140046563160e+00,1.61091625416890039e-01,5.82914413703832374e-02,1.20824530215488182e-01,1.80324904387144908e-01,5.63493090536958618e-01,6.08402387687988044e-01,5.72659168317469325e-01,

