1
1
15
0
(8 0
((0,0,0) (7,7,7) (0,0,0))
((8,0,0) (15,7,7) (0,0,0))
((0,8,0) (7,15,7) (0,0,0))
((8,8,0) (15,15,7) (0,0,0))
((0,0,8) (7,7,15) (0,0,0))
((8,0,8) (15,7,15) (0,0,0))
((0,8,8) (7,15,15) (0,0,0))
((8,8,8) (15,15,15) (0,0,0))
)
8
FabOnDisk: Cell_D_00000 0
FabOnDisk: Cell_D_00000 61527
FabOnDisk: Cell_D_00000 123055
FabOnDisk: Cell_D_00000 184583
FabOnDisk: Cell_D_00000 246112
FabOnDisk: Cell_D_00000 307640
FabOnDisk: Cell_D_00000 369169
FabOnDisk: Cell_D_00000 430698

8,15
1.2372650279788388e-02,6.5436030712007154e-02,-1.5251477603929925e-02,-1.4144829948211372e-02,-1.1620475852020036e-02,6.3185888271869817e-01,-2.8614630368003248e-03,-1.6486301436597958e-03,-6.5952556885589300e-05,-9.4961583176612248e-03,-3.7373806130073087e-02,-1.3678316356635037e-01,-3.4050276425045289e-01,-3.8101993096768949e-01,-4.4718534582037928e-01,
1.2140620220124056e-02,2.8869103762321956e-02,-1.0093794880962154e-02,-1.4513414528084401e-02,-1.1051223743324814e-02,6.3376393266128173e-01,-7.5094087038110012e-03,-1.7224407874120199e-03,-6.6194474240708376e-04,-3.5810847404424023e-01,-4.9687728954958044e-02,-1.7510349808216058e-01,-9.0729283606960864e-02,-4.4171888481422417e-01,-4.9221442764834805e-01,
1.2145719549249921e-02,9.7668743963227091e-03,-1.3305948162038009e-02,-9.9668578418214346e-03,-1.0167384476680507e-02,6.2963470448278303e-01,-2.5360746684613142e-03,-9.7342931115360701e-03,-2.0492163162179118e-02,-1.6950914125747507e-02,-3.9578255690573494e-01,-2.2148049458979507e-01,-4.1662875050563386e-01,-1.8237408028891805e-01,-5.6210830472735629e-01,
1.2176260682293024e-02,3.1667904407138058e-03,-1.6028809291345536e-02,-1.4675777292686243e-02,-1.2765906089252804e-02,6.2790502437900542e-01,-1.6596756066142804e-02,-1.3020881585851428e-02,-4.8421623138298751e-02,-4.2570214912050869e-01,-4.0555010350429505e-01,-2.7521384723037118e-01,-9.0001594456319500e-02,-1.8202799572585232e-01,-6.0631693009313381e-01,
1.2180022957802903e-02,2.0501979249535427e-03,-1.3310634089595081e-02,-1.4446443532756975e-02,-1.2016946815000719e-02,6.2871777757406955e-01,-2.9136694883580257e-03,-2.7895517942994615e-02,-5.3214362839647941e-03,-2.4452443745473746e-02,-9.4568536013854204e-02,-4.3615102003674200e-01,-5.1406732119232679e-01,-5.1886006405357854e-01,-2.8952152293107114e-01,
1.2209742277085104e-02,3.5825231054571548e-04,-1.4305349502882807e-02,-1.3379658589614830e-02,-1.1169876478072790e-02,6.2948269774424648e-01,-8.8847559521019914e-02,-1.5127831854272680e-01,-1.8119838021153727e-02,-4.5962800056539344e-01,-1.2323250909816386e-01,-4.4546930047559208e-01,-9.1407875378971062e-02,-5.9728437834321624e-01,-2.9478949291414253e-01,
1.2308725591209097e-02,-4.4050573516649550e-04,-1.4767798288968143e-02,-1.1239896973985967e-02,-1.0042570551793105e-02,6.2985581442292449e-01,-3.5450545712712014e-02,-5.9189244835255457e-02,-1.5375720363893580e-01,-4.2576116562878422e-02,-4.8599238528342942e-01,-4.5424497914693984e-01,-5.8042830265696554e-01,-1.8737945411005313e-01,-2.9383533245099952e-01,
1.2406782914729610e-02,-8.2764506042858510e-04,-1.6905925456562450e-02,-1.1596212124998331e-02,-1.4109118453904074e-02,6.2928156233235399e-01,-6.5438706924093079e-02,-2.2442760121419575e+01,-3.7339925325487840e+01,-4.7726489913039516e-01,-5.0537182141314674e-01,-5.0058120627812730e-01,-9.3641682280895658e-02,-1.9004582037411843e-01,-2.9502110526430991e-01,

8,15
7.5430441480519816e-01,1.0550729572850404e+00,1.3213951945506675e-02,1.6045783991752174e-02,1.6853950924767810e-02,1.0674456075648286e+00,9.2318283135958031e-03,1.1528640192690433e-02,9.5643240923287392e-03,3.6645024020394068e-01,4.0035189206798100e-01,4.1675195427729378e-01,1.0534910667060341e-03,4.2880733405717148e-03,2.1484006626424634e-02,
9.1620785859510767e-01,1.0560918442369769e+00,1.8700986121927395e-02,1.9725878837825606e-02,2.0764145941607408e-02,1.0682370754663115e+00,5.1146882450421732e-03,1.6125225896183357e-02,1.0015118972467610e-02,5.7707854909304315e-02,4.2467166611590895e-01,4.5857051329697074e-01,3.3676173736671228e-01,6.0387992669041672e-03,3.0978760263183337e-02,
1.0656992835294090e+00,1.0560726407378009e+00,1.8778318381213306e-02,1.9888093701658456e-02,1.8600330524335535e-02,1.0754661579257316e+00,1.9627097593554167e-02,1.1336310727753355e-02,1.3290601678123730e-02,4.2019619587488083e-01,1.1808307585489722e-01,4.8847334785301622e-01,2.0010638804128242e-03,3.8943549602974326e-01,4.4355835327349220e-02,
1.1755889585138972e+00,1.0556734508688976e+00,1.6675858707734692e-02,2.0408152762666231e-02,2.1629751277426064e-02,1.1787557489546110e+00,1.9711953888282521e-02,1.3087477582941563e-02,1.3653450758983703e-02,5.9001820814764773e-02,1.1795336761796045e-01,4.9985094450063416e-01,4.2838278795927709e-01,4.3834139544735740e-01,6.3322820558726789e-02,
1.2098251221232790e+00,1.0557779490728290e+00,1.7829440096961080e-02,1.6180941986285835e-02,2.1900964041701464e-02,1.2118753200482326e+00,1.9895939124122290e-02,1.3816540578270486e-02,1.1612602697069218e-02,4.6385816458365553e-01,4.6748478970850549e-01,1.8647354574080913e-01,2.9725619190837538e-03,1.2809734702758771e-02,4.6403734805738250e-01,
1.2607874260556353e+00,1.0553624951870666e+00,1.6738352932389705e-02,1.6674898064307737e-02,2.1113554199975813e-02,1.2611456783661810e+00,1.0661834790142749e-01,1.3247736433986700e-02,4.7642198392664717e-02,5.9370147801069459e-02,5.0662195019229239e-01,1.8656159466946387e-01,5.1758626190707857e-01,1.8159657990681699e-02,5.1232094803931216e-01,
1.2829611719525125e+00,1.0544656972733593e+00,1.9188036008625613e-02,2.0582530944956892e-02,2.1546747932250278e-02,1.2825206662173461e+00,5.8814659291934135e-02,5.4426731780519398e-02,4.4688480861848789e-02,4.7680680679539444e-01,1.1991429714355291e-01,1.8639193756974720e-01,5.7588143289658529e-03,5.5444646502444606e-01,5.3259982617865997e-01,
1.2913507419462527e+00,1.0528687402999344e+00,1.8287022852640299e-02,1.9556903026488923e-02,2.1886671589386696e-02,1.2905974190891449e+00,1.5045056994691150e+01,6.1093394768956488e-01,3.6506614813481963e-01,5.9715705775756467e-02,1.2091845282369817e-01,1.8816084243865555e-01,5.6142313880873917e-01,6.0941913327996078e-01,5.8539059335351085e-01,

