1
1
15
0
(8 0
((0,0,0) (7,7,7) (0,0,0))
((8,0,0) (15,7,7) (0,0,0))
((0,8,0) (7,15,7) (0,0,0))
((8,8,0) (15,15,7) (0,0,0))
((0,0,8) (7,7,15) (0,0,0))
((8,0,8) (15,7,15) (0,0,0))
((0,8,8) (7,15,15) (0,0,0))
((8,8,8) (15,15,15) (0,0,0))
)
8
FabOnDisk: Cell_D_00000 0
FabOnDisk: Cell_D_00000 61527
FabOnDisk: Cell_D_00000 123055
FabOnDisk: Cell_D_00000 184583
FabOnDisk: Cell_D_00000 246112
FabOnDisk: Cell_D_00000 307640
FabOnDisk: Cell_D_00000 369169
FabOnDisk: Cell_D_00000 430698

8,15
1.23748595873301222e-02,6.05640961033105107e-02,-1.52213938930632862e-02,-1.43512840794116185e-02,-1.16195358147525869e-02,6.33262886132571978e-01,-2.82915994123001096e-03,-1.56466078112525459e-03,-1.54093855120747137e-04,-9.78243058011135647e-03,-3.68778191334313554e-02,-1.33094076102230452e-01,-3.45782214185688219e-01,-3.86563795622757889e-01,-4.45154001056123794e-01,
1.21422967219281842e-02,2.60811533691615895e-02,-1.01749149021643105e-02,-1.46848644623287609e-02,-1.10008056619592502e-02,6.34378646128177071e-01,-7.91952883603557270e-03,-1.83049844334535420e-03,-8.99902087960018126e-04,-3.58950073038521000e-01,-4.90692006480132684e-02,-1.70547030748530615e-01,-9.07454490622295468e-02,-4.46017973329323802e-01,-4.98251068395198171e-01,
1.21461622451241348e-02,9.01062505706668598e-03,-1.34876959325966779e-02,-9.90489328936312342e-03,-1.01086389074526040e-02,6.29426149122218170e-01,-2.39359433395410501e-03,-9.67798637361617572e-03,-2.27514240037580764e-02,-1.73103461775989120e-02,-3.97755906619239985e-01,-2.14598379869957778e-01,-4.21851637299476778e-01,-1.78333812479579745e-01,-5.63338712233184657e-01,
1.21776160336408094e-02,2.93587405156551552e-03,-1.59297059484543591e-02,-1.44047559374265843e-02,-1.29174949539731364e-02,6.27892552300797213e-01,-1.54603421743644987e-02,-1.17793362976872235e-02,-4.95123533384791495e-02,-4.28233692473689809e-01,-4.07481438591973222e-01,-2.67236478086157692e-01,-9.05619982567965193e-02,-1.79888508312215256e-01,-6.04363137136560535e-01,
1.21834372334424668e-02,1.98576397870274448e-03,-1.33436749031538016e-02,-1.45484859994997485e-02,-1.18122139754607072e-02,6.28682692572581914e-01,-2.95435530272999351e-03,-2.58888395950849608e-02,-5.74060288484753815e-03,-2.46610716758257804e-02,-9.15607869322188211e-02,-4.37769056689487290e-01,-5.15878947450691738e-01,-5.21665885108557159e-01,-2.85847226971152391e-01,
1.22134308034853346e-02,3.18163222816695646e-04,-1.43526873290920620e-02,-1.35419035250871189e-02,-1.11902455126734277e-02,6.29691099881762195e-01,-9.54217275069764725e-02,-1.76178667622653412e-01,-2.03880049442017389e-02,-4.59993072887138310e-01,-1.19449987843266159e-01,-4.48383310785629263e-01,-9.16370128758202951e-02,-5.98827184371304333e-01,-2.90309925190061380e-01,
1.23080759402483791e-02,-4.38288077565442840e-04,-1.46282740832924460e-02,-1.12588275260676329e-02,-9.75379085494568893e-03,6.28604780373563377e-01,-2.85621186780044845e+00,-2.26320012261632703e-01,-2.41975238135951454e-01,-4.25560932465791214e-02,-4.85258620806759300e-01,-4.49984101418386628e-01,-5.80545399707082743e-01,-1.84419305918848031e-01,-2.89235685475887072e-01,
1.24037756962046622e-02,-8.23879621918789597e-04,-1.68742552845999524e-02,-1.14947018245582060e-02,-1.41213561007998388e-02,6.28801810258795335e-01,-1.16771654780444642e-01,-2.21037053216577503e-02,-3.15977633750571196e-01,-4.77116423725940264e-01,-5.06323290005556093e-01,-4.97805541734841039e-01,-9.33913565251700689e-02,-1.86888017267380940e-01,-2.90133612302941324e-01,

8,15
7.71522205708430997e-01,1.05507035363374002e+00,1.32792202113454928e-02,1.57986788318048924e-02,1.69924014830842469e-02,1.06744521322107011e+00,9.66491030328976014e-03,1.19187614779627388e-02,9.63390827503680588e-03,3.67942689714819915e-01,4.02580384615956688e-01,4.21274979788139325e-01,1.08499315579212467e-03,4.22328795262511859e-03,2.05707613302398701e-02,
9.33058457884184955e-01,1.05609029091647977e+00,1.86312601358857438e-02,1.95624463275760954e-02,2.07663564333403737e-02,1.06823258763840800e+00,5.14616928701566202e-03,1.59383709436577217e-02,1.00150996112476354e-02,5.80314416280498582e-02,4.24931050533243593e-01,4.61431213358296066e-01,3.41608461609626102e-01,5.95273911985149968e-03,2.96340852188416472e-02,
1.07491769609563681e+00,1.05608118944173501e+00,1.87092131443609491e-02,2.02163767718421747e-02,1.85985801620906326e-02,1.08392832115270354e+00,1.85461807309629731e-02,1.08268741632474644e-02,1.34745139844665122e-02,4.22974576095535904e-01,1.15839913584953672e-01,4.88050078363958584e-01,2.04632807398209913e-03,3.93091286445934662e-01,4.19614993321710539e-02,
1.18207971841729220e+00,1.05568353432603290e+00,1.68865731488950510e-02,2.06726758897626192e-02,2.16389938431351368e-02,1.18501559246885768e+00,2.00165981472372051e-02,1.17970388239962195e-02,1.36890372028315339e-02,5.91134861276280815e-02,1.16454662378989160e-01,4.97053781675642292e-01,4.33725334287190845e-01,4.42179397963862020e-01,5.98742114105181647e-02,
1.21195172739025914e+00,1.05576122510049664e+00,1.78188012916108314e-02,1.61535046025193425e-02,2.16799190725718086e-02,1.21393749136896179e+00,2.01954132381600079e-02,1.39159144542572548e-02,1.21550796123853864e-02,4.64489760538162599e-01,4.69329382391293737e-01,1.83404221829074926e-01,2.99928852297442084e-03,1.23145655388984462e-02,4.65384924021256752e-01,
1.26180583511108457e+00,1.05534525701697235e+00,1.67807637457941111e-02,1.67510937635088515e-02,2.08792652556286581e-02,1.26212399833390121e+00,1.13983019503425695e-01,1.29751141099821391e-02,5.36323807230411759e-02,5.92511100572625932e-02,5.07303533397996498e-01,1.83265944514744816e-01,5.19156411631527703e-01,1.74530462491771579e-02,5.15036312818195952e-01,
1.28273968101500135e+00,1.05448414520817901e+00,1.91341970082075374e-02,2.08461277639088900e-02,2.13151168665891913e-02,1.28230139293743584e+00,5.95161506568985393e-02,3.77263119093896523e-02,3.96072817398867016e+00,4.76714514708676096e-01,1.17909455917540207e-01,1.83719891082938569e-01,5.75386969189113726e-03,5.52309741512254426e-01,5.36953527592975099e-01,
1.29124501205884079e+00,1.05292307450525824e+00,1.81750207779807181e-02,1.98711370787831056e-02,2.16874950557318404e-02,1.29046645050089315e+00,7.50023674410117414e-02,5.51553735572500203e-01,3.03238042917725048e-01,5.97387716932368529e-02,1.18903525819422679e-01,1.85070863221180160e-01,5.61438469784185323e-01,6.09441515900120079e-01,5.80831689500673320e-01,

