1
1
15
0
(8 0
((0,0,0) (7,7,7) (0,0,0))
((8,0,0) (15,7,7) (0,0,0))
((0,8,0) (7,15,7) (0,0,0))
((8,8,0) (15,15,7) (0,0,0))
((0,0,8) (7,7,15) (0,0,0))
((8,0,8) (15,7,15) (0,0,0))
((0,8,8) (7,15,15) (0,0,0))
((8,8,8) (15,15,15) (0,0,0))
)
8
FabOnDisk: Cell_D_00000 0
FabOnDisk: Cell_D_00000 61527
FabOnDisk: Cell_D_00000 123055
FabOnDisk: Cell_D_00000 184583
FabOnDisk: Cell_D_00000 246112
FabOnDisk: Cell_D_00000 307640
FabOnDisk: Cell_D_00000 369169
FabOnDisk: Cell_D_00000 430698

8,15
1.23726502797883876e-02,6.54360307120071538e-02,-1.52514776039299246e-02,-1.41448299482113717e-02,-1.16204758520200360e-02,6.31858882718698167e-01,-2.86146303680032479e-03,-1.64863014365979575e-03,-6.59525568855892999e-05,-9.49615831766122478e-03,-3.73738061300730867e-02,-1.36783163566350369e-01,-3.40502764250452894e-01,-3.81019930967689491e-01,-4.47185345820379276e-01,
1.21406202201240557e-02,2.88691037623219557e-02,-1.00937948809621536e-02,-1.45134145280844014e-02,-1.10512237433248138e-02,6.33763932661281726e-01,-7.50940870381100120e-03,-1.72244078741201991e-03,-6.61944742407083756e-04,-3.58108474044240233e-01,-4.96877289549580436e-02,-1.75103498082160580e-01,-9.07292836069608644e-02,-4.41718884814224166e-01,-4.92214427648348052e-01,
1.21457195492499209e-02,9.76687439632270907e-03,-1.33059481620380095e-02,-9.96685784182143458e-03,-1.01673844766805074e-02,6.29634704482783025e-01,-2.53607466846131422e-03,-9.73429311153607008e-03,-2.04921631621791181e-02,-1.69509141257475071e-02,-3.95782556905734939e-01,-2.21480494589795074e-01,-4.16628750505633860e-01,-1.82374080288918050e-01,-5.62108304727356289e-01,
1.21762606822930237e-02,3.16679044071380578e-03,-1.60288092913455360e-02,-1.46757772926862425e-02,-1.27659060892528035e-02,6.27905024379005416e-01,-1.65967560661428037e-02,-1.30208815858514279e-02,-4.84216231382987514e-02,-4.25702149120508688e-01,-4.05550103504295045e-01,-2.75213847230371178e-01,-9.00015944563195003e-02,-1.82027995725852321e-01,-6.06316930093133810e-01,
1.21800229578029034e-02,2.05019792495354271e-03,-1.33106340895950814e-02,-1.44464435327569755e-02,-1.20169468150007185e-02,6.28717777574069547e-01,-2.91366948835802570e-03,-2.78955179429946146e-02,-5.32143628396479409e-03,-2.44524437454737460e-02,-9.45685360138542042e-02,-4.36151020036741999e-01,-5.14067321192326787e-01,-5.18860064053578540e-01,-2.89521522931071140e-01,
1.22097422770851040e-02,3.58252310545715484e-04,-1.43053495028828068e-02,-1.33796585896148301e-02,-1.11698764780727901e-02,6.29482697744246478e-01,-8.88475595210199143e-02,-1.51278318542726803e-01,-1.81198380211537273e-02,-4.59628000565393435e-01,-1.23232509098163856e-01,-4.45469300475592078e-01,-9.14078753789710624e-02,-5.97284378343216238e-01,-2.94789492914142526e-01,
1.23087255912090968e-02,-4.40505735166495495e-04,-1.47677982889681432e-02,-1.12398969739859675e-02,-1.00425705517931049e-02,6.29855814422924487e-01,-3.54505457127120144e-02,-5.91892448352554570e-02,-1.53757203638935802e-01,-4.25761165628784216e-02,-4.85992385283429418e-01,-4.54244979146939842e-01,-5.80428302656965545e-01,-1.87379454110053134e-01,-2.93835332450999520e-01,
1.24067829147296096e-02,-8.27645060428585104e-04,-1.69059254565624498e-02,-1.15962121249983310e-02,-1.41091184539040744e-02,6.29281562332353994e-01,-6.54387069240930791e-02,-2.24427601214195747e+01,-3.73399253254878403e+01,-4.77264899130395159e-01,-5.05371821413146738e-01,-5.00581206278127300e-01,-9.36416822808956578e-02,-1.90045820374118435e-01,-2.95021105264309913e-01,

8,15
7.54304414805198165e-01,1.05507295728504036e+00,1.32139519455066745e-02,1.60457839917521744e-02,1.68539509247678104e-02,1.06744560756482865e+00,9.23182831359580305e-03,1.15286401926904328e-02,9.56432409232873919e-03,3.66450240203940680e-01,4.00351892067980997e-01,4.16751954277293779e-01,1.05349106670603408e-03,4.28807334057171481e-03,2.14840066264246343e-02,
9.16207858595107671e-01,1.05609184423697688e+00,1.87009861219273946e-02,1.97258788378256063e-02,2.07641459416074078e-02,1.06823707546631153e+00,5.11468824504217323e-03,1.61252258961833567e-02,1.00151189724676098e-02,5.77078549093043153e-02,4.24671666115908952e-01,4.58570513296970739e-01,3.36761737366712277e-01,6.03879926690416725e-03,3.09787602631833373e-02,
1.06569928352940901e+00,1.05607264073780094e+00,1.87783183812133062e-02,1.98880937016584561e-02,1.86003305243355350e-02,1.07546615792573164e+00,1.96270975935541672e-02,1.13363107277533546e-02,1.32906016781237299e-02,4.20196195874880829e-01,1.18083075854897218e-01,4.88473347853016215e-01,2.00106388041282422e-03,3.89435496029743256e-01,4.43558353273492204e-02,
1.17558895851389722e+00,1.05567345086889763e+00,1.66758587077346920e-02,2.04081527626662311e-02,2.16297512774260639e-02,1.17875574895461099e+00,1.97119538882825213e-02,1.30874775829415632e-02,1.36534507589837033e-02,5.90018208147647730e-02,1.17953367617960450e-01,4.99850944500634164e-01,4.28382787959277089e-01,4.38341395447357396e-01,6.33228205587267889e-02,
1.20982512212327897e+00,1.05577794907282896e+00,1.78294400969610800e-02,1.61809419862858350e-02,2.19009640417014637e-02,1.21187532004823262e+00,1.98959391241222902e-02,1.38165405782704857e-02,1.16126026970692180e-02,4.63858164583655530e-01,4.67484789708505488e-01,1.86473545740809127e-01,2.97256191908375385e-03,1.28097347027587710e-02,4.64037348057382504e-01,
1.26078742605563532e+00,1.05536249518706660e+00,1.67383529323897051e-02,1.66748980643077367e-02,2.11135541999758133e-02,1.26114567836618097e+00,1.06618347901427490e-01,1.32477364339867003e-02,4.76421983926647169e-02,5.93701478010694589e-02,5.06621950192292392e-01,1.86561594669463870e-01,5.17586261907078571e-01,1.81596579906816991e-02,5.12320948039312163e-01,
1.28296117195251247e+00,1.05446569727335926e+00,1.91880360086256127e-02,2.05825309449568922e-02,2.15467479322502785e-02,1.28252066621734606e+00,5.88146592919341349e-02,5.44267317805193981e-02,4.46884808618487894e-02,4.76806806795394444e-01,1.19914297143552909e-01,1.86391937569747201e-01,5.75881432896585294e-03,5.54446465024446056e-01,5.32599826178659974e-01,
1.29135074194625266e+00,1.05286874029993438e+00,1.82870228526402986e-02,1.95569030264889226e-02,2.18866715893866956e-02,1.29059741908914494e+00,1.50450569946911497e+01,6.10933947689564882e-01,3.65066148134819635e-01,5.97157057757564669e-02,1.20918452823698175e-01,1.88160842438655551e-01,5.61423138808739175e-01,6.09419133279960779e-01,5.85390593353510846e-01,

