1
1
15
0
(8 0
((0,0,0) (7,7,7) (0,0,0))
((8,0,0) (15,7,7) (0,0,0))
((0,8,0) (7,15,7) (0,0,0))
((8,8,0) (15,15,7) (0,0,0))
((0,0,8) (7,7,15) (0,0,0))
((8,0,8) (15,7,15) (0,0,0))
((0,8,8) (7,15,15) (0,0,0))
((8,8,8) (15,15,15) (0,0,0))
)
8
FabOnDisk: Cell_D_00000 0
FabOnDisk: Cell_D_00000 61527
FabOnDisk: Cell_D_00000 123055
FabOnDisk: Cell_D_00000 184583
FabOnDisk: Cell_D_00000 246112
FabOnDisk: Cell_D_00000 307640
FabOnDisk: Cell_D_00000 369169
FabOnDisk: Cell_D_00000 430698

8,15
1.20344382231195954e-02,6.25155109015706773e-03,-1.40230563915331174e-02,-9.39702933972806978e-03,-7.90071286402504493e-03,6.29942629998701431e-01,-1.78378328729337805e-03,-1.02426371208104022e-02,-1.89118579552084026e-02,-9.96853018621758971e-03,-2.87453152434679060e-02,-6.47612488971280875e-02,-4.45369203283025872e-01,-4.45949184833054124e-01,-5.03412084111773295e-01,
1.18372724842072969e-02,2.66100300504462563e-03,-8.42489363929881802e-03,-1.08603110437711647e-02,-6.10415329137520279e-03,6.31714926913379715e-01,-1.61432359895028119e-02,-1.92068163042128093e-02,-3.00896753565732568e-02,-4.15937382251831411e-01,-3.55936502781750846e-02,-7.94196269572844671e-02,-5.42237245532835588e-02,-5.01931391068863642e-01,-5.12794821336248763e-01,
1.19134840049433983e-02,1.51500680826478122e-03,-1.22811306532312030e-02,-4.43473605218989812e-03,-5.93636200560690788e-03,6.28909848944485983e-01,-1.92834688262233096e-03,-5.55514319639112235e-03,-2.27421669705435425e-02,-1.45482541178736189e-02,-4.41127294661544656e-01,-9.26231571649669960e-02,-5.16607784893354016e-01,-1.18866237617936590e-01,-5.45372039707010980e-01,
1.18877843512112322e-02,3.20079838434802891e-04,-1.26577787028788018e-02,-8.10066188881442689e-03,-7.27240351631995661e-03,6.28139954182264759e-01,-7.66871564395837368e-02,-4.77864161550016903e-02,-1.89574521576624688e-01,-4.63010829750584607e-01,-4.47053845098416114e-01,-1.12755063857107068e-01,-5.60023344553847863e-02,-1.21167285399704450e-01,-6.01926260437246397e-01,
1.19580687011036583e-02,4.63903443293323158e-04,-1.25301879862192277e-02,-7.50382179767279320e-03,-2.36232859359987273e-03,6.28428490070755297e-01,-1.49229969359185206e-02,-3.23573820502371726e-02,-3.81796082475459406e-03,-1.73119070365396199e-02,-4.98929710981102087e-02,-4.44552197726847287e-01,-5.38876771272404964e-01,-5.77033281349827343e-01,-1.83143124776107641e-01,
1.19454894500062494e-02,-3.02928347305843858e-04,-1.25159284464982958e-02,-1.24227174345066856e-02,-3.52172584448385336e-03,6.30175973696775360e-01,-3.24086459451892323e-02,-1.14542929762125073e-01,-3.34980019410126371e-03,-4.77553507634002727e-01,-6.12722738543143991e-02,-4.75604255496443362e-01,-5.67115141540635581e-02,-6.01685732231258985e-01,-1.81892866909840911e-01,
1.20343302792131485e-02,-3.89437063932402197e-04,-1.14726565378982515e-02,-9.33952943457448496e-03,-3.27063625370309537e-03,6.29201490031713773e-01,-2.83790178778112745e-02,-1.29414560443080699e-02,-2.00373243972794407e-02,-2.49929655634079442e-02,-4.63666194638240325e-01,-4.94499399513166404e-01,-5.73030739568708758e-01,-1.22509699193266874e-01,-1.87606717892236374e-01,
1.20443452738596638e-02,-8.47551350417530920e-04,-1.63414380703495489e-02,-1.45434865530514688e-02,-5.57219219745716532e-03,6.25915499539887676e-01,-2.78233634823071632e-02,-1.61908127040394229e-02,-2.31849900865452180e-02,-4.83110632552713082e-01,-4.97975612524422184e-01,-5.10303582488817575e-01,-6.06662304831945970e-02,-1.24895035160164827e-01,-1.88669874642655194e-01,

8,15
1.11547681282903532e+00,1.05634542491552263e+00,1.69857819040077872e-02,2.18531487922095195e-02,2.58460525722995632e-02,1.12172836391919239e+00,1.38181250201596141e-02,1.28937312269937487e-02,1.64228449107147491e-02,4.32610826135478188e-01,4.35554425889217001e-01,4.32338276013954248e-01,1.13173787081634857e-03,3.31805207707114389e-03,7.85107332493736702e-03,
1.19000859714779628e+00,1.05711167949317764e+00,2.14527424440952193e-02,2.24300443120071802e-02,2.55286093666990260e-02,1.19266960015284096e+00,1.83672269169463907e-02,1.87263271000040581e-02,1.86562363031484955e-02,3.42993264407376180e-02,4.63757782023401011e-01,4.60286068296392570e-01,4.26536871706612253e-01,4.31694141275622018e-03,1.02158830456575353e-02,
1.22846951546096816e+00,1.05680115172835531e+00,1.96817841395094360e-02,2.42667081628581867e-02,2.52384820286116925e-02,1.22998452226923294e+00,3.39728386582961311e-02,2.00042174859883723e-02,1.66912639487599990e-02,4.53170552323485298e-01,7.68957782158963543e-02,4.83822775190279386e-01,1.77166848800854428e-03,4.79064235548589512e-01,1.23281553117018383e-02,
1.26162029232779349e+00,1.05647550811910818e+00,1.96187383257001927e-02,2.49255374752836781e-02,2.60593177118846886e-02,1.26194037216622834e+00,1.30540018400661068e-01,7.52490373457219697e-02,2.19141086136897915e-02,3.74808609551226038e-02,7.85488104545819799e-02,5.11282845561401689e-01,5.08733881243765174e-01,5.14222392194209954e-01,1.59405547079336588e-02,
1.26021780746749767e+00,1.05626434714934447e+00,1.94631434650037842e-02,2.28745491609914850e-02,3.13138858375634557e-02,1.26068171091079106e+00,6.03734089279365435e-02,3.79078620637660207e-02,3.78995495048864428e-02,4.54138937699199108e-01,4.90789662332206167e-01,1.19247536713648739e-01,2.15831310603501868e-03,6.36288225973533246e-03,4.82989940901688120e-01,
1.27743177095060045e+00,1.05598079513458321e+00,2.05770095247021848e-02,2.56287285352681249e-02,3.14303959968904520e-02,1.27712884260329451e+00,2.24308165218655542e-01,2.70836456935774350e-02,3.05325775241772068e-01,3.73659900578253296e-02,4.93632880895256809e-01,1.18855007717915545e-01,5.50331848119342770e-01,8.23814060228242676e-03,5.29189405874023966e-01,
1.28445598569478636e+00,1.05530218809424281e+00,2.29363479137903205e-02,2.44881198263891126e-02,3.02512138327493095e-02,1.28406654863085401e+00,6.18431299304773724e-02,5.16039409390976964e-02,4.44824147800093259e-02,4.91559902963974338e-01,7.89333404120236143e-02,1.20177552486987707e-01,3.39009429240797692e-03,5.34509332205268084e-01,5.70405951056740967e-01,
1.29021010146517301e+00,1.05462912577631651e+00,1.99059280175808220e-02,2.36370696425614937e-02,3.11875100634859473e-02,1.28936255011475542e+00,9.79124590939770278e-02,1.96741031141399070e-01,2.39154134798347129e-01,3.94292400464030662e-02,8.13850226457508846e-02,1.21247944457660850e-01,5.90795833010731908e-01,5.82564349094081724e-01,6.12360107342331483e-01,

