1
1
15
0
(8 0
((0,0,0) (7,7,7) (0,0,0))
((8,0,0) (15,7,7) (0,0,0))
((0,8,0) (7,15,7) (0,0,0))
((8,8,0) (15,15,7) (0,0,0))
((0,0,8) (7,7,15) (0,0,0))
((8,0,8) (15,7,15) (0,0,0))
((0,8,8) (7,15,15) (0,0,0))
((8,8,8) (15,15,15) (0,0,0))
)
8
FabOnDisk: Cell_D_00000 0
FabOnDisk: Cell_D_00000 61527
FabOnDisk: Cell_D_00000 123055
FabOnDisk: Cell_D_00000 184583
FabOnDisk: Cell_D_00000 246112
FabOnDisk: Cell_D_00000 307640
FabOnDisk: Cell_D_00000 369169
FabOnDisk: Cell_D_00000 430698

8,15
1.23703200648434316e-02,5.02716619787905092e-02,-1.54603470037095875e-02,-1.55658961270113225e-02,-1.20521088102090203e-02,6.34068824072816506e-01,-2.61145879801128215e-03,-1.89438669772485366e-03,-6.23604741204630050e-04,-9.65358347507690520e-03,-3.88815462739133047e-02,-1.21543880060232395e-01,-3.54868874495073205e-01,-4.01439294131087421e-01,-4.36672936466002914e-01,
1.21469868908681763e-02,2.16059063956624380e-02,-9.87817867427579627e-03,-1.56605199138334129e-02,-1.16618738632246980e-02,6.31832707056374510e-01,-8.51826222038805717e-03,-1.56252351807872718e-03,-1.43239346532886345e-03,-3.62595157596500628e-01,-5.10021256576007193e-02,-1.54717616579516465e-01,-8.56576599429153124e-02,-4.55836127517184053e-01,-5.05926000655887997e-01,
1.21470096517983985e-02,6.89131032851462901e-03,-1.35282064980511239e-02,-1.01908104227027667e-02,-1.07626634969932890e-02,6.27986595110201273e-01,-2.09173266280115577e-03,-1.03964841144587108e-02,-3.10528866499852410e-02,-1.70407070506568004e-02,-4.01743532138187587e-01,-1.97551155596252942e-01,-4.39360812497260556e-01,-1.78596847411207682e-01,-5.66770810816144999e-01,
1.21777775036648241e-02,2.42421915897162669e-03,-1.54135051039893372e-02,-1.39682745491518986e-02,-1.31105043225416759e-02,6.28066408628083828e-01,-1.61759884911748947e-02,-1.04044638781912273e-02,-4.73008571117601029e-02,-4.33684729741582009e-01,-4.08089305914142497e-01,-2.45149701773105688e-01,-8.70954214956501105e-02,-1.80241106090612974e-01,-5.96505484647709361e-01,
1.21892782047391818e-02,1.93433870685528336e-03,-1.40340674658377147e-02,-1.53494271262980819e-02,-1.14588142459272433e-02,6.28378272458846698e-01,-2.96607454957604740e-03,-2.53486415152078329e-02,-7.57792159195387009e-03,-2.30285217779592558e-02,-9.11515324896578633e-02,-4.40212238820672841e-01,-5.16279936443496457e-01,-5.23815062261780318e-01,-2.74023864055888411e-01,
1.22194672813544132e-02,3.55975638690024607e-04,-1.43555130138566540e-02,-1.46489592442269161e-02,-1.10497247146028720e-02,6.28659435469085315e-01,-8.28273825042806083e-02,-1.50772750232572444e-01,-2.44783523848930012e-02,-4.61161329872208148e-01,-1.17419268332840998e-01,-4.55244196642839161e-01,-8.72070873339674257e-02,-5.97141934266539720e-01,-2.77068406454306970e-01,
1.23150692966843434e-02,-4.15569826904076535e-04,-1.40988771563044426e-02,-1.06326692877892447e-02,-9.86789967658281177e-03,6.27982804271395079e-01,-1.83013194522303579e-01,-2.83486276247765373e-02,-2.03020828406669136e-02,-3.96288048675522836e-02,-4.85582304026172418e-01,-4.56295801569449044e-01,-5.76564052890612855e-01,-1.83866426628569002e-01,-2.76078794077632250e-01,
1.24033288529908636e-02,-7.85692224177151287e-04,-1.67558626344202141e-02,-1.15029826584732674e-02,-1.40184198149000596e-02,6.27989241981494084e-01,-1.13219199472864740e-01,-2.17051071249922088e-02,-1.32955741001631239e-01,-4.71640470914263255e-01,-5.06202751681229857e-01,-4.87905533956613957e-01,-8.89481213603596776e-02,-1.85737949326381685e-01,-2.77136005037328492e-01,

8,15
8.11147657506041564e-01,1.05509848906917503e+00,1.32316632776908142e-02,1.56857235044179644e-02,1.72574928068494303e-02,1.06746880913401854e+00,1.03189111013779998e-02,1.19042890588018091e-02,9.63054355984105555e-03,3.68324848298420326e-01,4.08915305863214340e-01,4.30353801382458823e-01,1.07004398331161802e-03,4.46820102354936188e-03,1.79404985317872592e-02,
9.62763434530747197e-01,1.05606395033310752e+00,1.85585564310420253e-02,1.82779568517933075e-02,2.05637954684049912e-02,1.06821831083000851e+00,5.34216053460963725e-03,1.38329358483909991e-02,9.93690615148325358e-03,5.53529818138682253e-02,4.27043010053106686e-01,4.64231357181225768e-01,3.51781567338741108e-01,6.20584999130446499e-03,2.54016005014678845e-02,
1.10397191017761398e+00,1.05606685321246330e+00,1.82870990557679192e-02,2.07086135041782415e-02,1.82924566105048224e-02,1.11086322050612862e+00,1.50309612953334806e-02,1.05073761232205298e-02,1.35207405795869824e-02,4.31837013950744364e-01,1.14127061680079300e-01,4.85670876590590883e-01,2.01955598239486004e-03,4.05700021566114732e-01,3.64090129963311679e-02,
1.19749292547418174e+00,1.05568048887846788e+00,1.70571935579607974e-02,2.09812499360997815e-02,2.13172403104405182e-02,1.19991714463315335e+00,2.12674232514152885e-02,1.12369481087259068e-02,1.37718660065899896e-02,5.61095633929822313e-02,1.16597800069084517e-01,4.88923831594131331e-01,4.45020270544895624e-01,4.49661413136842159e-01,5.11351943758610039e-02,
1.21371896578102567e+00,1.05573739174288717e+00,1.75845216202166685e-02,1.61000816484938719e-02,2.14167490681483157e-02,1.21565330448788100e+00,2.00213438258658935e-02,1.30903553281241872e-02,1.35380829399689689e-02,4.63699048312971596e-01,4.70532702900470778e-01,1.74601374479173677e-01,2.79593276587184261e-03,1.22421812777386771e-02,4.64875968333097633e-01,
1.26115710178011042e+00,1.05534533204938530e+00,1.73422018495011446e-02,1.65017698053713073e-02,2.09237407468735176e-02,1.26151307741880037e+00,1.07467601825406156e-01,1.32725188749110191e-02,5.43233676734662940e-02,5.63902601654053051e-02,5.06492125812220806e-01,1.74593093322485127e-01,5.18239186271019059e-01,1.70564200552374458e-02,5.17211443345544697e-01,
1.28240575823280811e+00,1.05446595292093770e+00,1.90847403171121865e-02,2.11011412128216669e-02,2.13555659131914911e-02,1.28199018840590395e+00,5.67560325577283614e-02,4.05929647225422296e-02,3.15890339509998341e-01,4.73754519577430422e-01,1.17419799453891333e-01,1.76005424022634138e-01,5.34878052421818712e-03,5.52990326650889097e-01,5.47882950857290663e-01,
1.29152486630319330e+00,1.05299746359582169e+00,1.80443136910099430e-02,2.04176730677950967e-02,2.14790030064039433e-02,1.29073917407901617e+00,1.96953936726425000e-01,2.11392683181246088e+00,9.94454816793221674e-01,5.71461110017260632e-02,1.18364447231163794e-01,1.76788536066968316e-01,5.65316030822106130e-01,6.07958144335099648e-01,5.65290306630352735e-01,

