1
1
15
0
(8 0
((0,0,0) (7,7,7) (0,0,0))
((8,0,0) (15,7,7) (0,0,0))
((0,8,0) (7,15,7) (0,0,0))
((8,8,0) (15,15,7) (0,0,0))
((0,0,8) (7,7,15) (0,0,0))
((8,0,8) (15,7,15) (0,0,0))
((0,8,8) (7,15,15) (0,0,0))
((8,8,8) (15,15,15) (0,0,0))
)
8
FabOnDisk: Cell_D_00000 0
FabOnDisk: Cell_D_00000 61527
FabOnDisk: Cell_D_00000 123055
FabOnDisk: Cell_D_00000 184583
FabOnDisk: Cell_D_00000 246112
FabOnDisk: Cell_D_00000 307640
FabOnDisk: Cell_D_00000 369169
FabOnDisk: Cell_D_00000 430698

8,15
1.22504888082833174e-02,1.47826921595692138e-02,-1.42062003926513320e-02,-1.31520790454991553e-02,-8.31843130989797473e-03,6.28559476001070649e-01,-2.09731511133838403e-03,-4.78965959334076838e-04,-4.48971609737629142e-04,-9.94812258862888890e-03,-3.27693392375212125e-02,-8.51182581352468298e-02,-3.92227697232358508e-01,-4.47380043490587742e-01,-4.98760443070847215e-01,
1.20559680478594840e-02,5.86144185528512246e-03,-9.76619823221623780e-03,-1.32809224463184255e-02,-7.10932598671299744e-03,6.28569202132672089e-01,-8.65520338559731296e-03,-8.64953175071381079e-03,-2.24540485575406637e-02,-3.92442724293141865e-01,-4.13990589953229585e-02,-1.05807282263479824e-01,-6.68849190097228208e-02,-4.70218135801568016e-01,-5.33878134760478185e-01,
1.20828940489629295e-02,2.56862424861121000e-03,-1.34298144971755906e-02,-6.50689926608598312e-03,-7.66441309240656864e-03,6.29047864652609423e-01,-1.85343503054966443e-03,-4.80732797111151511e-03,-3.69008215664000799e-02,-1.57003865257827613e-02,-4.26563306019966559e-01,-1.29426383406217094e-01,-4.96145692171067187e-01,-1.43996809268123860e-01,-5.47292467757388046e-01,
1.21025756342865928e-02,9.42403840049071940e-04,-1.28072801929792080e-02,-9.08511372182184938e-03,-8.74818937083287132e-03,6.28177549783858202e-01,-4.00678873996226786e-02,-7.79934754057500824e-03,-3.30154635160874038e-02,-4.53046349806700555e-01,-4.32271941093497425e-01,-1.58818901815481917e-01,-6.87015283986508185e-02,-1.45866275583577065e-01,-5.69442897700366046e-01,
1.21292215011985522e-02,9.58670065228295321e-04,-1.16943192149543893e-02,-1.14639009222932166e-02,-5.36209477159741831e-03,6.28580928640117831e-01,-8.64082706031270645e-03,-1.85638572775556204e-02,-6.14882101569906060e-03,-1.93778947870770005e-02,-6.36047917586285705e-02,-4.49552419037996920e-01,-5.36375460011287553e-01,-5.64376335788332684e-01,-2.20295644214292985e-01,
1.21527845761414607e-02,-1.00501904742463178e-04,-1.42377561566025389e-02,-1.10268047021114153e-02,-7.73569804772248834e-03,6.27745127659226299e-01,-2.13033995329567107e-02,-1.88942777547089680e+00,-8.76494866894875387e-03,-4.71402687741788617e-01,-7.94179969594596136e-02,-4.75379161550002927e-01,-6.75571296971533286e-02,-6.08653679949511917e-01,-2.21906240569979096e-01,
1.22168727250208248e-02,-4.18498345435129452e-04,-1.24255061678165777e-02,-1.09801213699352099e-02,-6.62294211436932016e-03,6.28779597357636888e-01,-2.76228118568732292e-02,-4.16673837485206922e-02,-2.60686580797192188e-02,-2.99871164757055109e-02,-4.75381697715467066e-01,-4.89618021900570188e-01,-5.56630119015004032e-01,-1.47999820904660850e-01,-2.24131157997320418e-01,
1.22713200485407518e-02,-8.00402598736246968e-04,-1.73766993602932872e-02,-1.48830188893908991e-02,-9.24911305025375927e-03,6.28966928271672998e-01,-5.81826927650579903e-02,-1.78334262524183357e-02,-2.29215783822441371e-02,-4.77096684606528154e-01,-5.06122414052574743e-01,-4.92482171922001832e-01,-7.20696765795848654e-02,-1.48763158191199951e-01,-2.24534730155004136e-01,

8,15
1.01436876598963566e+00,1.05557586101399936e+00,1.55790552183137955e-02,1.92281738960195653e-02,2.20597634726721024e-02,1.06784785581816632e+00,1.18225432108128720e-02,1.07882955551049792e-02,1.28064885565564238e-02,4.07128612820487845e-01,4.07324946613149330e-01,4.52438960177490412e-01,1.11262812404753098e-03,3.75121022846819450e-03,1.08671420209099177e-02,
1.12072113617496494e+00,1.05644453227142265e+00,1.99154958949783259e-02,2.03919022862337276e-02,2.38165479880033219e-02,1.12658257803025008e+00,9.22875658177501820e-03,1.22773532346228970e-02,1.66453827966342102e-02,4.30407302597661037e-02,4.33216463038881172e-01,4.56947770505060413e-01,4.02572494370580181e-01,4.99071923824711411e-03,1.45486129039598018e-02,
1.19366903047223261e+00,1.05620843903619765e+00,1.82819278717140724e-02,2.34281532428224290e-02,2.28601606338407759e-02,1.19623765472084376e+00,1.62476671073518257e-02,9.03317270640563962e-03,1.41291346745577515e-02,4.53165733274978555e-01,9.25973283379040446e-02,4.54842192764140951e-01,1.89255124488395808e-03,4.52332325437783900e-01,1.89725474865980598e-02,
1.24547485246349066e+00,1.05588661511432780e+00,1.91657862406605546e-02,2.40875721480539561e-02,2.49417066809450340e-02,1.24641725630353983e+00,5.29602622867550166e-02,2.17305231758463252e-02,1.83753669416441903e-02,4.47900609696934987e-02,9.29606646026331918e-02,4.91444224816294462e-01,4.86714062530356151e-01,4.90448481386074553e-01,2.52343117428350874e-02,
1.24613852167193628e+00,1.05584218714569200e+00,2.00206724290388424e-02,2.10302121907003196e-02,2.67998830398379490e-02,1.24709719173716449e+00,4.45527879415123090e-02,1.81954771658719150e-02,2.71033960468207019e-02,4.61634920122850290e-01,4.91077340995292544e-01,1.41449196809568967e-01,2.38175937584544440e-03,8.16817298244061109e-03,4.75634490354035988e-01,
1.27271770992920885e+00,1.05554126955292737e+00,1.85206374244149194e-02,2.33001708765039027e-02,2.65774441949365760e-02,1.27261720802446643e+00,4.75428916658039713e-01,2.12578669527705537e-02,1.39300174384501901e-01,4.46718466812399267e-02,5.06562792439322562e-01,1.42231820653802660e-01,5.37444500441281336e-01,1.08216605657482506e-02,5.32933994283345536e-01,
1.28487215226314322e+00,1.05480852998469676e+00,2.18460010529296610e-02,2.35865957396825740e-02,2.54471874760255207e-02,1.28445365391770805e+00,6.27947603438958474e-02,4.84532052430713886e-02,5.24931219525789916e-02,4.80100466906583034e-01,9.45816434419481517e-02,1.43167175628059695e-01,4.06087517026394382e-03,5.34467086048576512e-01,5.76052471269279609e-01,
1.29138286080866904e+00,1.05392206290854284e+00,1.87329529979611484e-02,2.29560975770223830e-02,2.58071865246876954e-02,1.29058245820993278e+00,3.41802555878475722e+00,1.70304019650360372e+00,2.76282065466219873e+00,4.66658387901085284e-02,9.58402196232595316e-02,1.43759626108679428e-01,5.82112366306918538e-01,5.97170160316185084e-01,6.01299530209270072e-01,

