1
1
15
0
(8 0
((0,0,0) (7,7,7) (0,0,0))
((8,0,0) (15,7,7) (0,0,0))
((0,8,0) (7,15,7) (0,0,0))
((8,8,0) (15,15,7) (0,0,0))
((0,0,8) (7,7,15) (0,0,0))
((8,0,8) (15,7,15) (0,0,0))
((0,8,8) (7,15,15) (0,0,0))
((8,8,8) (15,15,15) (0,0,0))
)
8
FabOnDisk: Cell_D_00000 0
FabOnDisk: Cell_D_00000 61527
FabOnDisk: Cell_D_00000 123055
FabOnDisk: Cell_D_00000 184583
FabOnDisk: Cell_D_00000 246112
FabOnDisk: Cell_D_00000 307640
FabOnDisk: Cell_D_00000 369169
FabOnDisk: Cell_D_00000 430698

8,15
1.22945176146393668e-02,2.90932616437168667e-02,-1.29854742051969986e-02,-1.39272119381359215e-02,-7.24627642219679170e-03,6.27874750476617782e-01,-2.10191167806630984e-03,-9.55273892675576768e-05,9.28746221601837942e-04,-9.95678837728799018e-03,-3.33397339497915404e-02,-1.08136414735145583e-01,-3.75784767225175120e-01,-4.27126394072579907e-01,-4.75064712395612099e-01,
1.20747306174393328e-02,1.18778021617034005e-02,-9.41269085810910247e-03,-1.37300294246970097e-02,-7.24727870320101414e-03,6.27900927177551083e-01,-1.00647676874063927e-02,1.02905642877676418e-04,-1.73269593902230547e-03,-3.70965947709544164e-01,-4.28055950663257107e-02,-1.35234584950186282e-01,-7.44298228634365927e-02,-4.66570957106852646e-01,-5.29861985853688822e-01,
1.21042659274239427e-02,4.49067024870193534e-03,-1.40527041249311271e-02,-8.06715136265421032e-03,-7.46200156119486077e-03,6.28126465302743631e-01,-1.63691427908739290e-03,-7.71392926559280340e-03,-3.80790119707712371e-02,-1.63873568060564079e-02,-4.14242435581866242e-01,-1.68411481691191828e-01,-4.65649617654699588e-01,-1.58970233402738914e-01,-5.66568116203913785e-01,
1.21274400718078337e-02,1.74612297789280939e-03,-1.28589215346846530e-02,-1.05003242012745926e-02,-1.06115055554041743e-02,6.27993229906196437e-01,-2.04374087377582510e-02,-7.50823313437420925e-03,-3.90900144843412609e-02,-4.41396183498994232e-01,-4.22628834502075446e-01,-2.06859217329902478e-01,-7.82604099694970412e-02,-1.59845123001951195e-01,-5.78976218199022119e-01,
1.21572982548532830e-02,1.04226413204388147e-03,-1.26910328211924158e-02,-1.27959789499853451e-02,-6.37796779252189708e-03,6.29622035084166476e-01,-2.79553845667933473e-03,-2.56515322836759138e-02,-6.20404588656610270e-03,-2.16214641284297807e-02,-7.26969027507300691e-02,-4.48902640594081137e-01,-5.28211328417711679e-01,-5.46342207628176202e-01,-2.54948858732950034e-01,
1.21883394296480128e-02,-7.53260570979539970e-04,-1.38443388176642222e-02,-1.21020434057716401e-02,-7.92391455780628272e-03,6.28903510370948604e-01,-1.18845267197447280e+00,-1.97803012262784805e+00,-1.37563339144849417e+00,-4.65611014264964984e-01,-9.21592630056194129e-02,-4.67397864245132688e-01,-7.69490534758295042e-02,-6.03798199302972183e-01,-2.54921283965458656e-01,
1.22660085937209545e-02,-4.47617902234833970e-04,-1.23850207348818429e-02,-9.43241184487873981e-03,-7.74918143161197875e-03,6.28049190907293942e-01,-2.68397496065627926e-02,-1.64771617382324584e-02,-1.83189504335933007e-02,-3.49031029771463414e-02,-4.79568555548249398e-01,-4.71439729916708683e-01,-5.66860521261461248e-01,-1.63234304323308793e-01,-2.55829909288445401e-01,
1.23326736257462540e-02,-7.49115660802813902e-04,-1.51847321979823278e-02,-1.31727980445366360e-02,-9.87835252839615145e-03,6.27155040608454284e-01,-5.54589766472374374e-02,-1.72062835306865530e-02,-2.93902512782843912e-02,-4.71359377628865039e-01,-5.07557331417156310e-01,-4.71038484773954380e-01,-8.06778454780402582e-02,-1.64299530418740014e-01,-2.57559049348400126e-01,

8,15
9.12548093213302769e-01,1.05540056147127737e+00,1.48471530722420475e-02,1.75115495141452589e-02,2.11850109279867749e-02,1.06770281739377415e+00,1.38143869689893936e-02,1.27054617984354232e-02,1.06169577857465006e-02,3.77116510228511281e-01,4.12693135268860090e-01,4.49719070091471551e-01,1.09678378730837479e-03,3.85571022622684719e-03,1.49424794967567484e-02,
1.04302867819546630e+00,1.05633615282551063e+00,1.82878309709027381e-02,1.97512284351046320e-02,2.29399842265103314e-02,1.06843416778252820e+00,7.24005492397858039e-03,1.35834804965824403e-02,1.37931349703066461e-02,4.94167418796511160e-02,4.17189656742895265e-01,4.70616623360846698e-01,3.77260878530191635e-01,5.20920378877068845e-03,2.04480321551927073e-02,
1.14645524540323152e+00,1.05622682355145714e+00,1.75691972932103257e-02,2.35895433949320013e-02,2.19580973677073882e-02,1.15094591565193349e+00,1.60137630252364591e-02,7.80372342535315053e-03,1.48728072656777975e-02,4.43400415275220561e-01,1.02072487720397120e-01,4.76988819198748137e-01,1.95396257606606861e-03,4.24748678066959595e-01,2.78779946716100069e-02,
1.21982134266061903e+00,1.05588437733672880e+00,1.93390598890300670e-02,2.37657530179032905e-02,2.46480454709741628e-02,1.22156746563851182e+00,3.26383795207308008e-02,9.93232930803029240e-03,1.67484742015189675e-02,5.07761701887543687e-02,1.02165975940448683e-01,4.76862515285933597e-01,4.61501700361819589e-01,4.67770026458483923e-01,3.78789934282886473e-02,
1.23316181430685190e+00,1.05577780014226041e+00,1.86067906996030298e-02,1.80726138163217927e-02,2.44226237629137297e-02,1.23420407843889568e+00,6.23780359420281552e-02,2.00466013879146351e-02,3.81894461954091421e-02,4.64449574283701427e-01,4.83096216230306796e-01,1.62406292668212160e-01,2.61831356745015342e-03,9.49529676993040098e-03,4.78219554006105052e-01,
1.27104044362896573e+00,1.05539319337585535e+00,1.86707036379950286e-02,2.05711955470412738e-02,2.45211073499492643e-02,1.27098468405891563e+00,1.22828836151441712e+00,1.79487577174324321e-02,3.99651909078161949e-02,5.06422361493856776e-02,5.07823940992057743e-01,1.62676706261815934e-01,5.27664745896173404e-01,1.28059389785498776e-02,5.30483071882615231e-01,
1.28318938572716168e+00,1.05469220181522561e+00,1.92178113874014629e-02,2.34149841784554447e-02,2.38234654306183000e-02,1.28276561261067412e+00,7.69896180098747218e-02,8.50048416789331018e-02,1.93542697225200233e-01,4.68062535166377913e-01,1.04270917149214243e-01,1.63679514162075379e-01,4.70555553530121497e-03,5.39806952515007099e-01,5.65165106329531097e-01,
1.29115631447537171e+00,1.05357418228438915e+00,1.70867742511959936e-02,2.29834808068345650e-02,2.36767711008845361e-02,1.29053426924096981e+00,2.87459110547815366e-01,4.71303812897117314e-01,2.31743910241759943e-01,5.22982046912127824e-02,1.05303562459921854e-01,1.64427582792866567e-01,5.72531823850009780e-01,6.01209511143532715e-01,5.72331892790744035e-01,

