1
1
15
0
(8 0
((0,0,0) (7,7,7) (0,0,0))
((8,0,0) (15,7,7) (0,0,0))
((0,8,0) (7,15,7) (0,0,0))
((8,8,0) (15,15,7) (0,0,0))
((0,0,8) (7,7,15) (0,0,0))
((8,0,8) (15,7,15) (0,0,0))
((0,8,8) (7,15,15) (0,0,0))
((8,8,8) (15,15,15) (0,0,0))
)
8
FabOnDisk: Cell_D_00000 0
FabOnDisk: Cell_D_00000 61527
FabOnDisk: Cell_D_00000 123055
FabOnDisk: Cell_D_00000 184583
FabOnDisk: Cell_D_00000 246112
FabOnDisk: Cell_D_00000 307640
FabOnDisk: Cell_D_00000 369169
FabOnDisk: Cell_D_00000 430698

8,15
1.22976479487782279e-02,2.70296693751814233e-02,-1.32277569756217954e-02,-1.37765891076103326e-02,-7.47730783498064440e-03,6.28432411328143092e-01,-2.02068438417464134e-03,-1.67933819254330384e-04,9.37006239634770245e-04,-1.01774693198870558e-02,-3.32263234950678360e-02,-1.05014852680234985e-01,-3.78664683324629547e-01,-4.29295071945620887e-01,-4.78651564466966495e-01,
1.20813253666296229e-02,1.08811260995761196e-02,-9.70687516053466218e-03,-1.35942306405671936e-02,-7.10615810010788943e-03,6.28160849221189421e-01,-1.00959913143052697e-02,1.76593198807092189e-04,-6.36264450138091658e-03,-3.75211109256774755e-01,-4.26523623704061494e-02,-1.31550819651287426e-01,-7.51679161135636875e-02,-4.66826121312538755e-01,-5.31608847993171318e-01,
1.21034337074270529e-02,4.23048124910926221e-03,-1.41187880686693048e-02,-8.06768483574246513e-03,-7.81935802606187162e-03,6.28291987319089973e-01,-1.62484724838556343e-03,-7.30612881025844395e-03,-3.97654869643234016e-02,-1.66847892031860012e-02,-4.15619023876356519e-01,-1.62733229711629068e-01,-4.69182257635449629e-01,-1.56507731478857659e-01,-5.65100741736042078e-01,
1.21274143981075049e-02,1.64588423905845968e-03,-1.24949367361842471e-02,-1.01494648731011924e-02,-1.07407188259755846e-02,6.28098459346602800e-01,-2.17486686428888590e-02,-7.13297822792402763e-03,-3.92681463496850902e-02,-4.43169970217809572e-01,-4.24119426534926180e-01,-2.00433767104587324e-01,-7.86175600229976068e-02,-1.57695170971213272e-01,-5.74996253114865796e-01,
1.21647261103069084e-02,1.38749414454537433e-03,-1.27479209044017733e-02,-1.25547840730484903e-02,-6.40041492521100687e-03,6.29347376546631754e-01,-2.46255923540020802e-03,-2.39790388555384433e-02,-7.22559733446028439e-03,-2.17842353830738147e-02,-7.08596955867408507e-02,-4.49529196952471122e-01,-5.29044898911993688e-01,-5.47110600402868519e-01,-2.50619486237999844e-01,
1.21915174615990825e-02,-6.28950895021770372e-06,-1.41318828273847424e-02,-1.18389963101152278e-02,-8.06388580011706962e-03,6.28627921752534569e-01,-2.59125884963373077e-01,-1.67147834516167082e+00,-1.00224440400597872e-02,-4.66094943484758661e-01,-8.98655649492796776e-02,-4.69111162142259286e-01,-7.74616064323264408e-02,-6.03714472565162863e-01,-2.51202977599159383e-01,
1.22638045359407880e-02,-4.11309788329142960e-04,-1.26017778271393932e-02,-9.38304564468712098e-03,-7.56743852456083586e-03,6.27453119194891884e-01,-2.74015956609486647e-02,-1.60346208014873065e-02,-9.29822798561383973e-03,-3.50346499864685260e-02,-4.77500731244925147e-01,-4.74396958922589207e-01,-5.67084283319261639e-01,-1.60208476932309885e-01,-2.51769329760873961e-01,
1.23289750003919719e-02,-7.31029212489634297e-04,-1.55223926313140543e-02,-1.31694550957878707e-02,-9.68682325644029153e-03,6.26613097450516854e-01,-4.27667189640489123e-02,-1.67213967907530875e-02,-2.85268717517824268e-02,-4.71062080805524419e-01,-5.06758988479474204e-01,-4.73981656426940234e-01,-8.09305274599637636e-02,-1.61608869607545558e-01,-2.53481324884407888e-01,

8,15
9.24789290567499811e-01,1.05541668742275618e+00,1.48959911465257316e-02,1.72874581824110536e-02,2.10771414512715485e-02,1.06772399569094212e+00,1.31074141411156708e-02,1.24261887745966068e-02,1.06497653620256667e-02,3.80812621994534306e-01,4.11997702438754498e-01,4.51016145120089251e-01,1.13313110976846288e-03,3.78859867538779236e-03,1.43807608079267388e-02,
1.05367047109012568e+00,1.05634025079620808e+00,1.86079229534597962e-02,1.96619679440520299e-02,2.27895654669054773e-02,1.06844323182557810e+00,6.79167073638449643e-03,1.32136664331540081e-02,1.37292937789185547e-02,4.94722718354465435e-02,4.14644823662731421e-01,4.70091791310382257e-01,3.80125873405532722e-01,5.12273134034917348e-03,1.96863093786095594e-02,
1.15164662468037626e+00,1.05620210198295417e+00,1.73380653909916520e-02,2.39829227187570750e-02,2.17111029353116505e-02,1.15587710592948545e+00,1.57873611356295560e-02,7.94792829594502884e-03,1.47549667458695844e-02,4.44959511480153225e-01,1.00396870758559520e-01,4.74425811924668539e-01,1.99731361916617722e-03,4.27534571646498551e-01,2.64908011823993990e-02,
1.22318637387241091e+00,1.05585629995040908e+00,1.93435107065780335e-02,2.40468831503145367e-02,2.42704201154087043e-02,1.22483225811146945e+00,3.00502894618996166e-02,8.66522444064269856e-03,1.67399948980548781e-02,5.10733489423000758e-02,1.00602195848451093e-01,4.74431921197995099e-01,4.65469226819652637e-01,4.70682840797130020e-01,3.60425706952911679e-02,
1.23246245625234563e+00,1.05578767640952131e+00,1.89934048168681271e-02,1.83276207503749455e-02,2.46623839408218783e-02,1.23385028917559514e+00,4.06654371621698874e-02,1.65096567946470679e-02,2.76605553391474149e-02,4.65039730932839845e-01,4.83948601386283539e-01,1.60010671752628342e-01,2.65843350010415598e-03,9.12530083757473812e-03,4.78172250373311236e-01,
1.26806477977114862e+00,1.05542333001819699e+00,1.88605063634647574e-02,2.08671930123203106e-02,2.47051462899365686e-02,1.26805849026219830e+00,8.06246353735360466e-01,1.81094036559609761e-02,1.00597843252288088e+00,5.07948210114673171e-02,5.07769124055377885e-01,1.60370960956717101e-01,5.28753023641518549e-01,1.23253071377902347e-02,5.31627175211966008e-01,
1.28311412892473609e+00,1.05466849868099510e+00,1.94087189409782382e-02,2.36944459457659323e-02,2.38005387829302584e-02,1.28272744828087482e+00,5.98179169314727588e-02,8.75080341971238851e-02,1.39977626576976794e-01,4.68447117880900266e-01,1.02268648939153745e-01,1.61185337240299181e-01,4.71645262430261860e-03,5.36404417903502906e-01,5.66874226553994998e-01,
1.29109074112761735e+00,1.05356612375032488e+00,1.73548269051950095e-02,2.31561030707663033e-02,2.34342861136271167e-02,1.29038427784958176e+00,2.00593981276107169e-01,3.22172602478244086e-01,1.80718201033944897e-01,5.26586032892419134e-02,1.03514706744606888e-01,1.61936541118263555e-01,5.72053212922063348e-01,5.99418051788839445e-01,5.76207203318952033e-01,

