1
1
15
0
(8 0
((0,0,0) (7,7,7) (0,0,0))
((8,0,0) (15,7,7) (0,0,0))
((0,8,0) (7,15,7) (0,0,0))
((8,8,0) (15,15,7) (0,0,0))
((0,0,8) (7,7,15) (0,0,0))
((8,0,8) (15,7,15) (0,0,0))
((0,8,8) (7,15,15) (0,0,0))
((8,8,8) (15,15,15) (0,0,0))
)
8
FabOnDisk: Cell_D_00000 0
FabOnDisk: Cell_D_00000 61527
FabOnDisk: Cell_D_00000 123055
FabOnDisk: Cell_D_00000 184583
FabOnDisk: Cell_D_00000 246112
FabOnDisk: Cell_D_00000 307640
FabOnDisk: Cell_D_00000 369169
FabOnDisk: Cell_D_00000 430698

8,15
1.2294517614639367e-02,2.9093261643716867e-02,-1.2985474205196999e-02,-1.3927211938135921e-02,-7.2462764221967917e-03,6.2787475047661778e-01,-2.1019116780663098e-03,-9.5527389267557677e-05,9.2874622160183794e-04,-9.9567883772879902e-03,-3.3339733949791540e-02,-1.0813641473514558e-01,-3.7578476722517512e-01,-4.2712639407257991e-01,-4.7506471239561210e-01,
1.2074730617439333e-02,1.1877802161703400e-02,-9.4126908581091025e-03,-1.3730029424697010e-02,-7.2472787032010141e-03,6.2790092717755108e-01,-1.0064767687406393e-02,1.0290564287767642e-04,-1.7326959390223055e-03,-3.7096594770954416e-01,-4.2805595066325711e-02,-1.3523458495018628e-01,-7.4429822863436593e-02,-4.6657095710685265e-01,-5.2986198585368882e-01,
1.2104265927423943e-02,4.4906702487019353e-03,-1.4052704124931127e-02,-8.0671513626542103e-03,-7.4620015611948608e-03,6.2812646530274363e-01,-1.6369142790873929e-03,-7.7139292655928034e-03,-3.8079011970771237e-02,-1.6387356806056408e-02,-4.1424243558186624e-01,-1.6841148169119183e-01,-4.6564961765469959e-01,-1.5897023340273891e-01,-5.6656811620391379e-01,
1.2127440071807834e-02,1.7461229778928094e-03,-1.2858921534684653e-02,-1.0500324201274593e-02,-1.0611505555404174e-02,6.2799322990619644e-01,-2.0437408737758251e-02,-7.5082331343742092e-03,-3.9090014484341261e-02,-4.4139618349899423e-01,-4.2262883450207545e-01,-2.0685921732990248e-01,-7.8260409969497041e-02,-1.5984512300195119e-01,-5.7897621819902212e-01,
1.2157298254853283e-02,1.0422641320438815e-03,-1.2691032821192416e-02,-1.2795978949985345e-02,-6.3779677925218971e-03,6.2962203508416648e-01,-2.7955384566793347e-03,-2.5651532283675914e-02,-6.2040458865661027e-03,-2.1621464128429781e-02,-7.2696902750730069e-02,-4.4890264059408114e-01,-5.2821132841771168e-01,-5.4634220762817620e-01,-2.5494885873295003e-01,
1.2188339429648013e-02,-7.5326057097953997e-04,-1.3844338817664222e-02,-1.2102043405771640e-02,-7.9239145578062827e-03,6.2890351037094860e-01,-1.1884526719744728e+00,-1.9780301226278481e+00,-1.3756333914484942e+00,-4.6561101426496498e-01,-9.2159263005619413e-02,-4.6739786424513269e-01,-7.6949053475829504e-02,-6.0379819930297218e-01,-2.5492128396545866e-01,
1.2266008593720954e-02,-4.4761790223483397e-04,-1.2385020734881843e-02,-9.4324118448787398e-03,-7.7491814316119787e-03,6.2804919090729394e-01,-2.6839749606562793e-02,-1.6477161738232458e-02,-1.8318950433593301e-02,-3.4903102977146341e-02,-4.7956855554824940e-01,-4.7143972991670868e-01,-5.6686052126146125e-01,-1.6323430432330879e-01,-2.5582990928844540e-01,
1.2332673625746254e-02,-7.4911566080281390e-04,-1.5184732197982328e-02,-1.3172798044536636e-02,-9.8783525283961515e-03,6.2715504060845428e-01,-5.5458976647237437e-02,-1.7206283530686553e-02,-2.9390251278284391e-02,-4.7135937762886504e-01,-5.0755733141715631e-01,-4.7103848477395438e-01,-8.0677845478040258e-02,-1.6429953041874001e-01,-2.5755904934840013e-01,

8,15
9.1254809321330277e-01,1.0554005614712774e+00,1.4847153072242048e-02,1.7511549514145259e-02,2.1185010927986775e-02,1.0677028173937742e+00,1.3814386968989394e-02,1.2705461798435423e-02,1.0616957785746501e-02,3.7711651022851128e-01,4.1269313526886009e-01,4.4971907009147155e-01,1.0967837873083748e-03,3.8557102262268472e-03,1.4942479496756748e-02,
1.0430286781954663e+00,1.0563361528255106e+00,1.8287830970902738e-02,1.9751228435104632e-02,2.2939984226510331e-02,1.0684341677825282e+00,7.2400549239785804e-03,1.3583480496582440e-02,1.3793134970306646e-02,4.9416741879651116e-02,4.1718965674289527e-01,4.7061662336084670e-01,3.7726087853019163e-01,5.2092037887706884e-03,2.0448032155192707e-02,
1.1464552454032315e+00,1.0562268235514571e+00,1.7569197293210326e-02,2.3589543394932001e-02,2.1958097367707388e-02,1.1509459156519335e+00,1.6013763025236459e-02,7.8037234253531505e-03,1.4872807265677798e-02,4.4340041527522056e-01,1.0207248772039712e-01,4.7698881919874814e-01,1.9539625760660686e-03,4.2474867806695960e-01,2.7877994671610007e-02,
1.2198213426606190e+00,1.0558843773367288e+00,1.9339059889030067e-02,2.3765753017903291e-02,2.4648045470974163e-02,1.2215674656385118e+00,3.2638379520730801e-02,9.9323293080302924e-03,1.6748474201518967e-02,5.0776170188754369e-02,1.0216597594044868e-01,4.7686251528593360e-01,4.6150170036181959e-01,4.6777002645848392e-01,3.7878993428288647e-02,
1.2331618143068519e+00,1.0557778001422604e+00,1.8606790699603030e-02,1.8072613816321793e-02,2.4422623762913730e-02,1.2342040784388957e+00,6.2378035942028155e-02,2.0046601387914635e-02,3.8189446195409142e-02,4.6444957428370143e-01,4.8309621623030680e-01,1.6240629266821216e-01,2.6183135674501534e-03,9.4952967699304010e-03,4.7821955400610505e-01,
1.2710404436289657e+00,1.0553931933758554e+00,1.8670703637995029e-02,2.0571195547041274e-02,2.4521107349949264e-02,1.2709846840589156e+00,1.2282883615144171e+00,1.7948757717432432e-02,3.9965190907816195e-02,5.0642236149385678e-02,5.0782394099205774e-01,1.6267670626181593e-01,5.2766474589617340e-01,1.2805938978549878e-02,5.3048307188261523e-01,
1.2831893857271617e+00,1.0546922018152256e+00,1.9217811387401463e-02,2.3414984178455445e-02,2.3823465430618300e-02,1.2827656126106741e+00,7.6989618009874722e-02,8.5004841678933102e-02,1.9354269722520023e-01,4.6806253516637791e-01,1.0427091714921424e-01,1.6367951416207538e-01,4.7055555353012150e-03,5.3980695251500710e-01,5.6516510632953110e-01,
1.2911563144753717e+00,1.0535741822843891e+00,1.7086774251195994e-02,2.2983480806834565e-02,2.3676771100884536e-02,1.2905342692409698e+00,2.8745911054781537e-01,4.7130381289711731e-01,2.3174391024175994e-01,5.2298204691212782e-02,1.0530356245992185e-01,1.6442758279286657e-01,5.7253182385000978e-01,6.0120951114353272e-01,5.7233189279074403e-01,

