1
1
15
0
(8 0
((0,0,0) (7,7,7) (0,0,0))
((8,0,0) (15,7,7) (0,0,0))
((0,8,0) (7,15,7) (0,0,0))
((8,8,0) (15,15,7) (0,0,0))
((0,0,8) (7,7,15) (0,0,0))
((8,0,8) (15,7,15) (0,0,0))
((0,8,8) (7,15,15) (0,0,0))
((8,8,8) (15,15,15) (0,0,0))
)
8
FabOnDisk: Cell_D_00000 0
FabOnDisk: Cell_D_00000 61527
FabOnDisk: Cell_D_00000 123055
FabOnDisk: Cell_D_00000 184583
FabOnDisk: Cell_D_00000 246112
FabOnDisk: Cell_D_00000 307640
FabOnDisk: Cell_D_00000 369169
FabOnDisk: Cell_D_00000 430698

8,15
1.21654532864944182e-02,9.04965541193854944e-03,-1.43499999687383348e-02,-1.11472467100382968e-02,-8.09487420365443723e-03,6.31704359107143398e-01,-1.89885748989979900e-03,-5.46791839039462678e-03,-1.29677382062888379e-02,-9.94810630832674604e-03,-3.03959420414283872e-02,-7.30481240571066170e-02,-4.23693698828608967e-01,-4.49976521333045221e-01,-5.05373314245997962e-01,
1.19695961727009983e-02,3.67425167870160654e-03,-8.82616607006488432e-03,-1.19582108723374943e-02,-6.42001599189882290e-03,6.30576833276643045e-01,-1.11423671887671584e-02,-1.83647104821296238e-02,-3.10800703734733924e-02,-4.06040656654791610e-01,-3.79762724561010581e-02,-9.01779263093511335e-02,-5.98999003035753930e-02,-4.79578602203179882e-01,-5.26075733063567363e-01,
1.20233574482928474e-02,1.89037207719140992e-03,-1.27425819577489212e-02,-5.54278834387353370e-03,-6.67835573105350459e-03,6.29162692959130743e-01,-1.96201741609664578e-03,-4.39042304882743522e-03,-2.74344431402388234e-02,-1.50231578651741447e-02,-4.35104833875031960e-01,-1.07516174502719289e-01,-5.09559156895958321e-01,-1.30853512292509466e-01,-5.28000095596047103e-01,
1.20189461546466210e-02,5.58710333855213029e-04,-1.29681889268805656e-02,-8.72352570727343533e-03,-6.63641556584569029e-03,6.28411026039266685e-01,-5.96133811114631651e-02,-2.14367443035810221e-02,-7.80264071842560886e-02,-4.58972632697293048e-01,-4.40935688959683270e-01,-1.31448130920877204e-01,-6.12244381132456272e-02,-1.31821881695778742e-01,-5.90813928836018798e-01,
1.20665017609603575e-02,6.47936314141821278e-04,-1.13921966395489748e-02,-9.26214875448727951e-03,-3.71119533215342676e-03,6.28529559116482339e-01,-1.38768063915632733e-02,-2.64622682717143599e-02,-4.97375986962496439e-03,-1.81999088351398504e-02,-5.55297076074886542e-02,-4.47831145951205045e-01,-5.39372500892357554e-01,-5.73773395340603010e-01,-1.96268942831776899e-01,
1.20908977760981421e-02,-2.44301063851221230e-04,-1.35195183437788573e-02,-1.18951637845956248e-02,-5.64852179861838333e-03,6.28911440309520842e-01,-1.52848696354719541e-02,-2.34509611594393319e-01,-5.56024381007314602e-03,-4.75167066964079177e-01,-6.87097712355123208e-02,-4.76916134009128190e-01,-6.14331778295404279e-02,-6.06854501023880166e-01,-1.99928287487812273e-01,
1.21460202535586450e-02,-4.04058852846923995e-04,-1.19363925154156916e-02,-1.05502666306169536e-02,-5.27598975198860162e-03,6.29111385129974443e-01,-2.82287423133962406e-02,-1.60773362622073021e-02,-2.48423976948722106e-02,-2.70667872089513720e-02,-4.69534762526065741e-01,-4.94626641718199311e-01,-5.66677547982832652e-01,-1.33845230423234068e-01,-2.04280664526738903e-01,
1.21920267743095608e-02,-8.44235035670698204e-04,-1.72640134962010333e-02,-1.52119281721427319e-02,-7.53644932498555298e-03,6.27985031295047680e-01,-4.25958900032816293e-02,-1.65601223825219343e-02,-2.01039324773609196e-02,-4.80655271561873376e-01,-5.02524049588780941e-01,-5.04772600096515700e-01,-6.59735386063640128e-02,-1.35244031565267236e-01,-2.04464630754962740e-01,

8,15
1.07525846265680247e+00,1.05588161009839587e+00,1.64290026153091455e-02,2.07773277191183603e-02,2.41131794562902471e-02,1.08430811806874106e+00,1.31932154404360985e-02,1.19697565420538200e-02,1.47419578308903860e-02,4.23250356404524741e-01,4.18822009703113729e-01,4.44539814240011211e-01,1.12052725660618407e-03,3.49244495154396595e-03,9.01057770135237426e-03,
1.16365672782587515e+00,1.05668676549582941e+00,2.10512226069905495e-02,2.19307272161654090e-02,2.45706092876940389e-02,1.16733097950457676e+00,1.38948310651813480e-02,1.62318807993708271e-02,1.85274006907695903e-02,3.78054818871264298e-02,4.52744161174317594e-01,4.42823753060025083e-01,4.17321868381772654e-01,4.58986814339323000e-03,1.18697060009770351e-02,
1.21555964055313415e+00,1.05638763966575544e+00,1.90152204840580430e-02,2.33159871512637965e-02,2.38928693271497107e-02,1.21745001263032560e+00,2.11605959650686404e-02,1.30877095793651109e-02,1.53875354071267741e-02,4.54519708329526984e-01,8.35503585456354864e-02,4.71395727192015834e-01,1.82182231642930665e-03,4.68014976082203105e-01,1.48251296921285500e-02,
1.25598707287648637e+00,1.05604592309693568e+00,1.94454038102333075e-02,2.46765173825236259e-02,2.59157264319903151e-02,1.25654578321034149e+00,8.57730802039998880e-02,4.58363430366358834e-02,2.03000281256883880e-02,4.06481168877822624e-02,8.49342567934522619e-02,5.05147182167029474e-01,4.99813131504371289e-01,5.04476971157938658e-01,1.94037272803031270e-02,
1.25542752598308804e+00,1.05597185453337383e+00,2.01091660418268904e-02,2.25417175773811353e-02,2.93208799542143059e-02,1.25607546229722988e+00,5.46612756432183697e-02,2.97201758994375467e-02,3.33552285123824982e-02,4.56563052503212552e-01,4.92624368903032295e-01,1.29124472533749535e-01,2.25585401097499680e-03,7.09579754192753934e-03,4.73558569791471928e-01,
1.27607509378642758e+00,1.05567909504755297e+00,1.88568845736415171e-02,2.49765974009428550e-02,2.92238800617527911e-02,1.27583079272257627e+00,1.35757784061238507e-01,2.52714293336683965e-02,1.62648321594401846e-01,4.06923026899128903e-02,5.00486943343467772e-01,1.29301140252966351e-01,5.45373635559636916e-01,9.27946829849142854e-03,5.32405434401289845e-01,
1.28547196116316598e+00,1.05501742812795340e+00,2.29118052403305371e-02,2.40247115085808864e-02,2.79021058969725830e-02,1.28506790231031909e+00,6.29613334251068052e-02,5.07104838856355239e-02,4.74554162303341132e-02,4.87289811700197584e-01,8.58465801460484013e-02,1.30276147749533333e-01,3.67165239879858754e-03,5.26404341043245960e-01,5.75542798317353554e-01,
1.29101726073665901e+00,1.05426355705793040e+00,1.94226647088644455e-02,2.31626388577140241e-02,2.87463168185499024e-02,1.29017302570098824e+00,1.86790234649249642e+00,2.43850375294107202e+00,4.14115940977623964e+00,4.24532603769637445e-02,8.76958051872388650e-02,1.31194375313480993e-01,5.87647257348711816e-01,5.90290473931065485e-01,6.10962040732126455e-01,

