1
1
15
0
(8 0
((0,0,0) (7,7,7) (0,0,0))
((8,0,0) (15,7,7) (0,0,0))
((0,8,0) (7,15,7) (0,0,0))
((8,8,0) (15,15,7) (0,0,0))
((0,0,8) (7,7,15) (0,0,0))
((8,0,8) (15,7,15) (0,0,0))
((0,8,8) (7,15,15) (0,0,0))
((8,8,8) (15,15,15) (0,0,0))
)
8
FabOnDisk: Cell_D_00000 0
FabOnDisk: Cell_D_00000 61527
FabOnDisk: Cell_D_00000 123055
FabOnDisk: Cell_D_00000 184583
FabOnDisk: Cell_D_00000 246112
FabOnDisk: Cell_D_00000 307640
FabOnDisk: Cell_D_00000 369169
FabOnDisk: Cell_D_00000 430698

8,15
1.21134167728539476e-02,7.52866497631265834e-03,-1.42863694965524399e-02,-1.03238265447083196e-02,-8.02389917693844754e-03,6.32325391272257953e-01,-1.73388499397139129e-03,-6.73878300956606835e-03,-1.46908756415090307e-02,-9.94798914254354030e-03,-2.95584740396617751e-02,-6.88966529202682115e-02,-4.34506263985480423e-01,-4.48719319533021743e-01,-5.05218434614268963e-01,
1.19168721660535791e-02,3.12495551331159853e-03,-8.17241192123397547e-03,-1.14109424122679597e-02,-6.19375255152369332e-03,6.30575304844702922e-01,-1.37070274142808667e-02,-1.95813837845869171e-02,-3.14329075441435873e-02,-4.10873928193465077e-01,-3.67691975236043717e-02,-8.47957247775572298e-02,-5.72440477170685913e-02,-4.90886516799748041e-01,-5.20395140759139396e-01,
1.19798807887159433e-02,1.69765812492030728e-03,-1.25475065695458063e-02,-5.13363198055592686e-03,-6.25754470256401421e-03,6.28711951680929082e-01,-2.00230108714365444e-03,-4.96244731899898699e-03,-2.52730583217386055e-02,-1.47739018249493821e-02,-4.38098420543577172e-01,-1.00049271386895122e-01,-5.13308192732530588e-01,-1.25187138605848541e-01,-5.35981850937922943e-01,
1.19652436437468982e-02,4.33107734948462344e-04,-1.28443485335509745e-02,-8.50126744790343468e-03,-6.78400085625688060e-03,6.28338443782251677e-01,-7.01416826922765524e-02,-3.23608723681101523e-02,-1.22605000058567962e-01,-4.60975624021876307e-01,-4.43989992027011726e-01,-1.22090779492798077e-01,-5.84955306119933072e-02,-1.26681744565257048e-01,-5.96808828834699101e-01,
1.20253879292941505e-02,5.54973020660842558e-04,-1.19598114841069757e-02,-8.36723843063476302e-03,-3.07024394142899060e-03,6.28505455173536731e-01,-1.48863602947289751e-02,-2.96670561026363792e-02,-4.53447242804328864e-03,-1.77541776757767847e-02,-5.27192096073650501e-02,-4.46430599503311154e-01,-5.39382486861438082e-01,-5.75738275126439936e-01,-1.90191457225660887e-01,
1.20283888649391733e-02,-2.77612883437645139e-04,-1.30049362458274972e-02,-1.22307170566722054e-02,-4.76813162674013819e-03,6.29731099360717361e-01,-1.49841877316996362e-02,-1.58134251295329376e-01,-4.63708565010667248e-03,-4.76372065968234282e-01,-6.49986339299032656e-02,-4.76540265227618720e-01,-5.91950934808432305e-02,-6.04729223669659310e-01,-1.91279517654819375e-01,
1.21002956156143517e-02,-4.17410177938009870e-04,-1.17863882030155437e-02,-1.00034918253451774e-02,-4.43246417929812030e-03,6.29135143174590405e-01,-2.78202951933327197e-02,-1.45103764111062725e-02,-2.24334294084754075e-02,-2.60322268619549227e-02,-4.66820451573519257e-01,-4.95016577863340523e-01,-5.69959258619120446e-01,-1.28412384512710809e-01,-1.96325337683921491e-01,
1.21526343211260084e-02,-8.49846810853294361e-04,-1.69004839812582387e-02,-1.49830503933501818e-02,-6.70514878843362847e-03,6.28494600885460164e-01,-3.66631686833399084e-02,-1.64672974282039919e-02,-2.45625973645006331e-02,-4.81899130167616985e-01,-5.00501732241809716e-01,-5.08001200397173558e-01,-6.34413202365507189e-02,-1.30189742882502180e-01,-1.96870010655815275e-01,

8,15
1.09545633602699910e+00,1.05608616394155685e+00,1.66917173972580650e-02,2.13268215593947902e-02,2.51028520751128588e-02,1.10298500100331176e+00,1.36077593481143417e-02,1.20794822211563978e-02,1.55430345309090830e-02,4.28123253843357698e-01,4.27318038470344164e-01,4.39281423102362512e-01,1.12403787385089685e-03,3.40364294236598572e-03,8.42045005721349903e-03,
1.17709979409696053e+00,1.05690933510189522e+00,2.13230875539849388e-02,2.23017704289494578e-02,2.47566134279628598e-02,1.18022474961027202e+00,1.56975487076023157e-02,1.75782309742173876e-02,1.86761959118181553e-02,3.61760347889525102e-02,4.58539619193753911e-01,4.50437813333557036e-01,4.22062248027892051e-01,4.45207767300786518e-03,1.10278442560543012e-02,
1.22220100231480400e+00,1.05654100166506515e+00,1.93002385430684174e-02,2.37609874352647452e-02,2.45408389346060476e-02,1.22389866043972440e+00,2.73973049332396634e-02,1.67795791699612944e-02,1.60351889593769587e-02,4.54111370570759121e-01,8.03392136473662366e-02,4.77879578462013399e-01,1.79584330970700688e-03,4.73484435841045548e-01,1.35466102455004834e-02,
1.25898355831930009e+00,1.05625749609076913e+00,1.95310071232448514e-02,2.47494237021898753e-02,2.60550739065564529e-02,1.25941666605424851e+00,1.05038033046786800e-01,5.72581136578524733e-02,2.10451679809967838e-02,3.91254570517518344e-02,8.18595764592072450e-02,5.08625672578656984e-01,5.04298500659563831e-01,5.09330076160502410e-01,1.76274502751711179e-02,
1.25789288973094404e+00,1.05604188699995016e+00,1.97825435032535878e-02,2.27345619209335520e-02,3.02551120240782540e-02,1.25844786275160492e+00,5.72233543416915402e-02,3.28686939304271494e-02,3.49450597283348860e-02,4.55459243271825076e-01,4.92050487851250273e-01,1.24466895116471535e-01,2.20721847541510393e-03,6.72994958970457406e-03,4.75524868600081918e-01,
1.27673415553449332e+00,1.05575148714420353e+00,1.96866331850252436e-02,2.53184663648150718e-02,3.02409382202745644e-02,1.27645654265105568e+00,2.04973589494878705e-01,2.64922468035397769e-02,2.63542493774106601e-01,3.91027983471774893e-02,4.97199963390716815e-01,1.24302272075231118e-01,5.47895678386131069e-01,8.75797885550130828e-03,5.31218995186794496e-01,
1.28543875506028837e+00,1.05510885040306812e+00,2.29294621539731097e-02,2.42219392767449998e-02,2.89470436408048350e-02,1.28502134488235042e+00,6.41112963722782619e-02,5.04930500704068516e-02,4.49856649788097224e-02,4.89461615909643766e-01,8.25323522811715338e-02,1.25435293032394035e-01,3.53455451509987906e-03,5.29555238953141494e-01,5.73618401164516567e-01,
1.29076722337852123e+00,1.05440705322254002e+00,1.95917063572850769e-02,2.32316545057210805e-02,2.98472451674079986e-02,1.29003488133265876e+00,1.16217294605952898e-01,2.77143180571241987e-01,4.04396940107415781e-01,4.07364023361713457e-02,8.46572860443387532e-02,1.26417912113618275e-01,5.89347064243060048e-01,5.86793759013272798e-01,6.12262464129744943e-01,

