1
1
15
0
(8 0
((0,0,0) (7,7,7) (0,0,0))
((8,0,0) (15,7,7) (0,0,0))
((0,8,0) (7,15,7) (0,0,0))
((8,8,0) (15,15,7) (0,0,0))
((0,0,8) (7,7,15) (0,0,0))
((8,0,8) (15,7,15) (0,0,0))
((0,8,8) (7,15,15) (0,0,0))
((8,8,8) (15,15,15) (0,0,0))
)
8
FabOnDisk: Cell_D_00000 0
FabOnDisk: Cell_D_00000 61527
FabOnDisk: Cell_D_00000 123055
FabOnDisk: Cell_D_00000 184583
FabOnDisk: Cell_D_00000 246112
FabOnDisk: Cell_D_00000 307640
FabOnDisk: Cell_D_00000 369169
FabOnDisk: Cell_D_00000 430698

8,15
1.23556755683580481e-02,4.90765906343769848e-02,-1.46771506576869465e-02,-1.43248861397901016e-02,-1.03870234416988637e-02,6.32891609133836353e-01,-2.63395682618942570e-03,-1.11124642340495561e-03,1.13610477203103196e-04,-9.86628927216365303e-03,-3.58989187033887519e-02,-1.25165227092622677e-01,-3.56747439974411273e-01,-4.00561812038190634e-01,-4.40060233251456712e-01,
1.21299071127687012e-02,2.07761573613718664e-02,-1.01126523420438583e-02,-1.44873860675912066e-02,-9.95956386791004532e-03,6.30623105620523372e-01,-8.81143352704967867e-03,-1.50196846058632256e-03,-7.14617045869863536e-04,-3.62353357066676707e-01,-4.72894655383999107e-02,-1.59304530864716354e-01,-8.61613629918425300e-02,-4.53921849568092339e-01,-5.09979748140757527e-01,
1.21332600561500203e-02,7.22218248204194776e-03,-1.37043799842773567e-02,-9.55251185475619255e-03,-8.79248953321784717e-03,6.28728115503807805e-01,-2.06903633585941949e-03,-9.38152030099653755e-03,-2.89421018489101380e-02,-1.71422546075657052e-02,-4.02940026487267122e-01,-1.99795437337206422e-01,-4.36277182625591786e-01,-1.72208292898258231e-01,-5.66790305243857206e-01,
1.21654246238771160e-02,2.49318444233915647e-03,-1.51873465017980120e-02,-1.34337381373289266e-02,-1.25453465522851627e-02,6.27911732271196343e-01,-1.53550970173085624e-02,-1.02170130594523133e-02,-4.52850339370655941e-02,-4.32703522907111227e-01,-4.12203286156194670e-01,-2.48023753511892597e-01,-8.77040496204404274e-02,-1.74100504433864212e-01,-5.98518153383850282e-01,
1.21853622265897729e-02,1.79054290271314772e-03,-1.31686790042527778e-02,-1.42116584190738592e-02,-1.01715441534372016e-02,6.28861134789195697e-01,-2.92430648741031675e-03,-2.32732301533091143e-02,-6.33088932562128615e-03,-2.38086910953459810e-02,-8.55324518836219627e-02,-4.41989372329659402e-01,-5.20541361561053462e-01,-5.30216754333464380e-01,-2.77149922947445893e-01,
1.22133795819362092e-02,2.48126720909189213e-04,-1.41651065013750597e-02,-1.33539220597306725e-02,-1.01625933175995154e-02,6.29050996907590809e-01,-1.06712447306469241e-01,-2.29807051897682912e-01,-3.06767440825706436e-02,-4.61835818605395299e-01,-1.10709411362670318e-01,-4.55232976354947749e-01,-8.77415324560366083e-02,-6.01065093623490032e-01,-2.79573479605251696e-01,
1.23042030495825686e-02,-4.24511970234175528e-04,-1.42187474565030735e-02,-1.03095988266618949e-02,-9.12778622438858295e-03,6.27832945430143230e-01,-3.71621570913089228e-01,-2.17501932703011366e-02,-1.63570849764537174e-02,-4.03105698343140598e-02,-4.84075505996735322e-01,-4.55377754205794905e-01,-5.76911531295604796e-01,-1.77789488038893884e-01,-2.79072387926667664e-01,
1.23878511860662441e-02,-8.05083309955406884e-04,-1.65184464388752339e-02,-1.17489466331084369e-02,-1.32999310024769207e-02,6.27521724568660400e-01,-1.43877714093069875e-01,-2.04847099253943135e-02,-2.88704956211931041e-01,-4.72998078058369131e-01,-5.07748535128900391e-01,-4.89798026568696976e-01,-8.95036838553921743e-02,-1.79778237006097463e-01,-2.79856873911560888e-01,

8,15
8.15776147310911193e-01,1.05518860027898764e+00,1.37521836692958699e-02,1.59556450740578198e-02,1.82989266994761472e-02,1.06754427584734568e+00,1.09738823532985336e-02,1.27692213896932992e-02,9.99263524672061240e-03,3.69060577574353177e-01,4.07636565735643885e-01,4.32184088421244283e-01,1.10029917021486770e-03,4.10395851785968265e-03,1.86684667827204248e-02,
9.68254503999429583e-01,1.05615869656138672e+00,1.86040806585131349e-02,1.96827964680284483e-02,2.14823205739450435e-02,1.06830046853099803e+00,5.49252513012876090e-03,1.49873370267379520e-02,1.02810954710417599e-02,5.58551155109735589e-02,4.24233239917212845e-01,4.66396569705035291e-01,3.53026044866905364e-01,5.71628918325505463e-03,2.64755895642959128e-02,
1.09902704779188332e+00,1.05608399122485808e+00,1.85538186675924810e-02,2.14764781181210201e-02,1.92677815885717377e-02,1.10624923027392530e+00,1.65251636229430329e-02,9.97441976885909964e-03,1.40966010741637865e-02,4.30353416078230799e-01,1.10250703800898631e-01,4.86725570904502913e-01,2.03583736299806171e-03,4.03051161110971334e-01,3.70395266917768889e-02,
1.19501749104265387e+00,1.05571116236588458e+00,1.77330701300556851e-02,2.17583561223294586e-02,2.24608948256155537e-02,1.19751067548499313e+00,2.09773843654280576e-02,1.08824334295849357e-02,1.44921602838848466e-02,5.68686950314478135e-02,1.12552137159650678e-01,4.90755946385484476e-01,4.43058815616086232e-01,4.50097647907819698e-01,5.21018113442638792e-02,
1.21863181719129754e+00,1.05570967719171449e+00,1.79840705407830620e-02,1.64421628291648615e-02,2.20873224173452308e-02,1.22042236009401073e+00,2.12880200159881738e-02,1.39911577055954073e-02,1.64729145792525886e-02,4.65136724779724564e-01,4.74507952323649285e-01,1.76048471981504445e-01,2.90160304693917303e-03,1.13548195199776360e-02,4.70089751573745440e-01,
1.26374616983816890e+00,1.05531209759858813e+00,1.72900026150757044e-02,1.71198752352751185e-02,2.15540459252488818e-02,1.26399429655907802e+00,1.39635223951372983e-01,1.42679117305644573e-02,6.81385796892934048e-02,5.67816050905654637e-02,5.08093041966910963e-01,1.76211102186008106e-01,5.22270392696547958e-01,1.58630261954258132e-02,5.20747087743623993e-01,
1.28267682150524820e+00,1.05449179113990166e+00,1.93017370853718132e-02,2.18418943486513445e-02,2.20700297136554174e-02,1.28225230953501401e+00,6.35826049764134926e-02,1.73082396407055694e-01,8.28290136672162891e-01,4.73902246044423214e-01,1.13581968153705873e-01,1.77961677659800088e-01,5.44640003020093345e-03,5.49169183512167813e-01,5.47147914920960821e-01,
1.29164099501653196e+00,1.05306738183529203e+00,1.80249278011497677e-02,2.11339491642951807e-02,2.23114942998306962e-02,1.29083591170657663e+00,3.82508868938288282e-01,4.16194144259729115e-01,2.62501632680699037e-01,5.76337834025496265e-02,1.14628142335276142e-01,1.78535141091734850e-01,5.64559183090628025e-01,6.08304056763729672e-01,5.68023885800999606e-01,

