1
1
15
0
(8 0
((0,0,0) (7,7,7) (0,0,0))
((8,0,0) (15,7,7) (0,0,0))
((0,8,0) (7,15,7) (0,0,0))
((8,8,0) (15,15,7) (0,0,0))
((0,0,8) (7,7,15) (0,0,0))
((8,0,8) (15,7,15) (0,0,0))
((0,8,8) (7,15,15) (0,0,0))
((8,8,8) (15,15,15) (0,0,0))
)
8
FabOnDisk: Cell_D_00000 0
FabOnDisk: Cell_D_00000 61527
FabOnDisk: Cell_D_00000 123055
FabOnDisk: Cell_D_00000 184583
FabOnDisk: Cell_D_00000 246112
FabOnDisk: Cell_D_00000 307640
FabOnDisk: Cell_D_00000 369169
FabOnDisk: Cell_D_00000 430698

8,15
1.23517630475619665e-02,5.30499068900494170e-02,-1.49318641544471369e-02,-1.42922449364696839e-02,-1.04874398847146708e-02,6.35116410807091247e-01,-2.71166449982473360e-03,-1.26743458553265557e-03,3.52548574543859591e-04,-9.62277611971042515e-03,-3.64228451711516646e-02,-1.28773866776136225e-01,-3.52074003146783332e-01,-3.95874561568784977e-01,-4.42804924818369194e-01,
1.21245818592660998e-02,2.29868238593015882e-02,-1.00416526206592999e-02,-1.44140768414879224e-02,-1.00285209192777884e-02,6.32450733222002182e-01,-8.42143475487694589e-03,-1.50132594998463845e-03,-5.00747184672896287e-04,-3.61861981436709723e-01,-4.78958185895232216e-02,-1.63779453008686821e-01,-8.62639221450045013e-02,-4.50655727797341810e-01,-5.05051388340361895e-01,
1.21315997809062701e-02,7.79118302472558717e-03,-1.35313408910109657e-02,-9.49106833924993204e-03,-8.88588855780762799e-03,6.28844026177963977e-01,-2.15020962547916514e-03,-9.52624054003629005e-03,-2.73970107908622015e-02,-1.68207338975591147e-02,-4.01041532608184925e-01,-2.06479181473395501e-01,-4.31502191013116709e-01,-1.74385172302548241e-01,-5.66479124864020855e-01,
1.21619239594047100e-02,2.68794776185189320e-03,-1.53795481359973122e-02,-1.37045310669207179e-02,-1.23818601900135480e-02,6.27928868410009944e-01,-1.45936854648457699e-02,-1.09660695202429791e-02,-4.45948271278829717e-02,-4.30341633846152372e-01,-4.10338253031050981e-01,-2.55854486198819120e-01,-8.70058011963494859e-02,-1.76314785741494867e-01,-6.01259689244339590e-01,
1.21794585916813816e-02,1.80301615499007650e-03,-1.31842882670442259e-02,-1.41219466605275821e-02,-1.04960900144175136e-02,6.28792434303622971e-01,-2.91854486712270038e-03,-4.19845933536234922e-02,-3.25908445166847027e-02,-2.36705496197634827e-02,-8.83582269995270286e-02,-4.40621668573965508e-01,-5.18999752920766833e-01,-5.27885480400591245e-01,-2.81041743981272130e-01,
1.22072525609570586e-02,2.85029202515789956e-04,-1.41236317467143442e-02,-1.32394499630909598e-02,-1.01666073960017325e-02,6.29336507816750546e-01,-9.94341933741584028e-02,-1.98862873775245308e-01,-1.77946890029155071e-02,-4.61484683713376476e-01,-1.14182181465526389e-01,-4.52533061335084974e-01,-8.76222917132628148e-02,-6.00013767888341487e-01,-2.84253905508542015e-01,
1.23007121901051487e-02,-7.01135041615593107e-04,-1.42825424438098245e-02,-1.01976135857536586e-02,-8.76084035281304505e-03,6.27817135020045325e-01,-1.14392071552662378e+00,-8.20112992365255922e-01,-4.75545233034073422e-02,-4.03908193656172809e-02,-4.85111231423379918e-01,-4.51948893161346288e-01,-5.76929069599635636e-01,-1.80891661276448901e-01,-2.83529094584088481e-01,
1.23865173282126460e-02,-8.03032984259366683e-04,-1.65886176612704828e-02,-1.11545580730397047e-02,-1.33394719293691514e-02,6.28197592613523370e-01,-1.32050327885672703e+00,-2.13265629425961993e-02,-3.91066285723921592e+00,-4.73302677368673042e-01,-5.07256293944900793e-01,-4.93345261659092538e-01,-8.95402964979987726e-02,-1.82865361521743042e-01,-2.84690134802902284e-01,

8,15
7.99774774563880353e-01,1.05516978899155234e+00,1.37545796935021267e-02,1.62090594676160410e-02,1.81341513461598935e-02,1.06752155203911436e+00,1.05374175352160558e-02,1.25183725019257387e-02,1.00398228394642918e-02,3.68124241004243569e-01,4.06267552835468226e-01,4.28638011739452929e-01,1.06759347418319958e-03,4.16580708185049393e-03,1.95021194113630877e-02,
9.52908683141208135e-01,1.05613518289546615e+00,1.87743609674061104e-02,1.98871135727080803e-02,2.14774452876783269e-02,1.06826951902242318e+00,5.34402026475009565e-03,1.54568973069732184e-02,1.05078442918745216e-02,5.55523287753905207e-02,4.24807173996332055e-01,4.64553907927327814e-01,3.48670495610279851e-01,5.79182175451627493e-03,2.76944167778273749e-02,
1.09097122020596982e+00,1.05611071468701434e+00,1.87671233927751355e-02,2.13010116092978569e-02,1.92657432615714053e-02,1.09876240323069529e+00,1.74829749409622717e-02,1.04848826227367867e-02,1.40474971202227909e-02,4.28021992329787326e-01,1.12534218199689284e-01,4.87925028197479238e-01,1.99148005874070708e-03,3.99602278810875788e-01,3.91716789430834114e-02,
1.18931671235894787e+00,1.05573270957354248e+00,1.75651980398531908e-02,2.15729028843813335e-02,2.24687323059291517e-02,1.19200466012079986e+00,2.05944229440027451e-02,1.14056890013263384e-02,1.44663144195162057e-02,5.66134647137393823e-02,1.14190701507916492e-01,4.93266213899845041e-01,4.37977339707627866e-01,4.46500637507030007e-01,5.51553083164014746e-02,
1.21691726220321383e+00,1.05573016678018949e+00,1.79939633613407576e-02,1.64095595495963378e-02,2.22785382881928451e-02,1.21872027835820385e+00,2.10531330883734213e-02,1.39286698427878424e-02,1.57959133609427912e-02,4.64668688840347788e-01,4.73046131298238248e-01,1.79171380564721622e-01,2.88174240507036231e-03,1.17973958240539037e-02,4.68998650210246393e-01,
1.26283981185992400e+00,1.05533422873071836e+00,1.71286497097766083e-02,1.70209162633691014e-02,2.17242595746390821e-02,1.26312484106243983e+00,1.29218773068885906e-01,1.41252898887962754e-02,6.15115205031413759e-02,5.69687311395392637e-02,5.07778829224025063e-01,1.79177662026730244e-01,5.20850062118614066e-01,1.64760223547442408e-02,5.18395971415204992e-01,
1.28332139778173082e+00,1.05445901936258668e+00,1.94000810211554173e-02,2.16227700980319987e-02,2.22642593395324211e-02,1.28316485886474707e+00,6.29589005997313322e-02,3.92513698703025604e-02,4.23188166187723969e+00,4.73698181763517079e-01,1.15606234591986046e-01,1.80622316376868569e-01,5.46033611626037772e-03,5.51641006723474270e-01,5.43086780280016779e-01,
1.29149315664332942e+00,1.05301339565232221e+00,1.81600294932849002e-02,2.08208520675219888e-02,2.24124065157631225e-02,1.29074590183309801e+00,3.13396494316993657e+00,1.20674727402808024e+00,2.53526051271533048e-01,5.76938475005331144e-02,1.16603411074660240e-01,1.81642826417253073e-01,5.64512417360758856e-01,6.08809731621843708e-01,5.73465428523582066e-01,

