1
1
15
0
(8 0
((0,0,0) (7,7,7) (0,0,0))
((8,0,0) (15,7,7) (0,0,0))
((0,8,0) (7,15,7) (0,0,0))
((8,8,0) (15,15,7) (0,0,0))
((0,0,8) (7,7,15) (0,0,0))
((8,0,8) (15,7,15) (0,0,0))
((0,8,8) (7,15,15) (0,0,0))
((8,8,8) (15,15,15) (0,0,0))
)
8
FabOnDisk: Cell_D_00000 0
FabOnDisk: Cell_D_00000 61527
FabOnDisk: Cell_D_00000 123055
FabOnDisk: Cell_D_00000 184583
FabOnDisk: Cell_D_00000 246112
FabOnDisk: Cell_D_00000 307640
FabOnDisk: Cell_D_00000 369169
FabOnDisk: Cell_D_00000 430698

8,15
1.2351763047561966e-02,5.3049906890049417e-02,-1.4931864154447137e-02,-1.4292244936469684e-02,-1.0487439884714671e-02,6.3511641080709125e-01,-2.7116644998247336e-03,-1.2674345855326556e-03,3.5254857454385959e-04,-9.6227761197104252e-03,-3.6422845171151665e-02,-1.2877386677613623e-01,-3.5207400314678333e-01,-3.9587456156878498e-01,-4.4280492481836919e-01,
1.2124581859266100e-02,2.2986823859301588e-02,-1.0041652620659300e-02,-1.4414076841487922e-02,-1.0028520919277788e-02,6.3245073322200218e-01,-8.4214347548769459e-03,-1.5013259499846384e-03,-5.0074718467289629e-04,-3.6186198143670972e-01,-4.7895818589523222e-02,-1.6377945300868682e-01,-8.6263922145004501e-02,-4.5065572779734181e-01,-5.0505138834036190e-01,
1.2131599780906270e-02,7.7911830247255872e-03,-1.3531340891010966e-02,-9.4910683392499320e-03,-8.8858885578076280e-03,6.2884402617796398e-01,-2.1502096254791651e-03,-9.5262405400362900e-03,-2.7397010790862202e-02,-1.6820733897559115e-02,-4.0104153260818493e-01,-2.0647918147339550e-01,-4.3150219101311671e-01,-1.7438517230254824e-01,-5.6647912486402086e-01,
1.2161923959404710e-02,2.6879477618518932e-03,-1.5379548135997312e-02,-1.3704531066920718e-02,-1.2381860190013548e-02,6.2792886841000994e-01,-1.4593685464845770e-02,-1.0966069520242979e-02,-4.4594827127882972e-02,-4.3034163384615237e-01,-4.1033825303105098e-01,-2.5585448619881912e-01,-8.7005801196349486e-02,-1.7631478574149487e-01,-6.0125968924433959e-01,
1.2179458591681382e-02,1.8030161549900765e-03,-1.3184288267044226e-02,-1.4121946660527582e-02,-1.0496090014417514e-02,6.2879243430362297e-01,-2.9185448671227004e-03,-4.1984593353623492e-02,-3.2590844516684703e-02,-2.3670549619763483e-02,-8.8358226999527029e-02,-4.4062166857396551e-01,-5.1899975292076683e-01,-5.2788548040059124e-01,-2.8104174398127213e-01,
1.2207252560957059e-02,2.8502920251578996e-04,-1.4123631746714344e-02,-1.3239449963090960e-02,-1.0166607396001733e-02,6.2933650781675055e-01,-9.9434193374158403e-02,-1.9886287377524531e-01,-1.7794689002915507e-02,-4.6148468371337648e-01,-1.1418218146552639e-01,-4.5253306133508497e-01,-8.7622291713262815e-02,-6.0001376788834149e-01,-2.8425390550854202e-01,
1.2300712190105149e-02,-7.0113504161559311e-04,-1.4282542443809824e-02,-1.0197613585753659e-02,-8.7608403528130450e-03,6.2781713502004532e-01,-1.1439207155266238e+00,-8.2011299236525592e-01,-4.7554523303407342e-02,-4.0390819365617281e-02,-4.8511123142337992e-01,-4.5194889316134629e-01,-5.7692906959963564e-01,-1.8089166127644890e-01,-2.8352909458408848e-01,
1.2386517328212646e-02,-8.0303298425936668e-04,-1.6588617661270483e-02,-1.1154558073039705e-02,-1.3339471929369151e-02,6.2819759261352337e-01,-1.3205032788567270e+00,-2.1326562942596199e-02,-3.9106628572392159e+00,-4.7330267736867304e-01,-5.0725629394490079e-01,-4.9334526165909254e-01,-8.9540296497998773e-02,-1.8286536152174304e-01,-2.8469013480290228e-01,

8,15
7.9977477456388035e-01,1.0551697889915523e+00,1.3754579693502127e-02,1.6209059467616041e-02,1.8134151346159894e-02,1.0675215520391144e+00,1.0537417535216056e-02,1.2518372501925739e-02,1.0039822839464292e-02,3.6812424100424357e-01,4.0626755283546823e-01,4.2863801173945293e-01,1.0675934741831996e-03,4.1658070818504939e-03,1.9502119411363088e-02,
9.5290868314120813e-01,1.0561351828954662e+00,1.8774360967406110e-02,1.9887113572708080e-02,2.1477445287678327e-02,1.0682695190224232e+00,5.3440202647500957e-03,1.5456897306973218e-02,1.0507844291874522e-02,5.5552328775390521e-02,4.2480717399633205e-01,4.6455390792732781e-01,3.4867049561027985e-01,5.7918217545162749e-03,2.7694416777827375e-02,
1.0909712202059698e+00,1.0561107146870143e+00,1.8767123392775135e-02,2.1301011609297857e-02,1.9265743261571405e-02,1.0987624032306953e+00,1.7482974940962272e-02,1.0484882622736787e-02,1.4047497120222791e-02,4.2802199232978733e-01,1.1253421819968928e-01,4.8792502819747924e-01,1.9914800587407071e-03,3.9960227881087579e-01,3.9171678943083411e-02,
1.1893167123589479e+00,1.0557327095735425e+00,1.7565198039853191e-02,2.1572902884381333e-02,2.2468732305929152e-02,1.1920046601207999e+00,2.0594422944002745e-02,1.1405689001326338e-02,1.4466314419516206e-02,5.6613464713739382e-02,1.1419070150791649e-01,4.9326621389984504e-01,4.3797733970762787e-01,4.4650063750703001e-01,5.5155308316401475e-02,
1.2169172622032138e+00,1.0557301667801895e+00,1.7993963361340758e-02,1.6409559549596338e-02,2.2278538288192845e-02,1.2187202783582038e+00,2.1053133088373421e-02,1.3928669842787842e-02,1.5795913360942791e-02,4.6466868884034779e-01,4.7304613129823825e-01,1.7917138056472162e-01,2.8817424050703623e-03,1.1797395824053904e-02,4.6899865021024639e-01,
1.2628398118599240e+00,1.0553342287307184e+00,1.7128649709776608e-02,1.7020916263369101e-02,2.1724259574639082e-02,1.2631248410624398e+00,1.2921877306888591e-01,1.4125289888796275e-02,6.1511520503141376e-02,5.6968731139539264e-02,5.0777882922402506e-01,1.7917766202673024e-01,5.2085006211861407e-01,1.6476022354744241e-02,5.1839597141520499e-01,
1.2833213977817308e+00,1.0544590193625867e+00,1.9400081021155417e-02,2.1622770098031999e-02,2.2264259339532421e-02,1.2831648588647471e+00,6.2958900599731332e-02,3.9251369870302560e-02,4.2318816618772397e+00,4.7369818176351708e-01,1.1560623459198605e-01,1.8062231637686857e-01,5.4603361162603777e-03,5.5164100672347427e-01,5.4308678028001678e-01,
1.2914931566433294e+00,1.0530133956523222e+00,1.8160029493284900e-02,2.0820852067521989e-02,2.2412406515763122e-02,1.2907459018330980e+00,3.1339649431699366e+00,1.2067472740280802e+00,2.5352605127153305e-01,5.7693847500533114e-02,1.1660341107466024e-01,1.8164282641725307e-01,5.6451241736075886e-01,6.0880973162184371e-01,5.7346542852358207e-01,

