1
1
15
0
(8 0
((0,0,0) (7,7,7) (0,0,0))
((8,0,0) (15,7,7) (0,0,0))
((0,8,0) (7,15,7) (0,0,0))
((8,8,0) (15,15,7) (0,0,0))
((0,0,8) (7,7,15) (0,0,0))
((8,0,8) (15,7,15) (0,0,0))
((0,8,8) (7,15,15) (0,0,0))
((8,8,8) (15,15,15) (0,0,0))
)
8
FabOnDisk: Cell_D_00000 0
FabOnDisk: Cell_D_00000 61527
FabOnDisk: Cell_D_00000 123055
FabOnDisk: Cell_D_00000 184583
FabOnDisk: Cell_D_00000 246112
FabOnDisk: Cell_D_00000 307640
FabOnDisk: Cell_D_00000 369169
FabOnDisk: Cell_D_00000 430698

8,15
1.2359320237513296e-02,5.7193557315000337e-02,-1.5066122595067715e-02,-1.4272138981378265e-02,-1.0870455014704489e-02,6.3449071846151495e-01,-2.7757129270870400e-03,-1.4194983761302072e-03,2.8825184955592892e-04,-9.5770860303013659e-03,-3.6739408783179196e-02,-1.3161853789919306e-01,-3.4817085517015356e-01,-3.9080506349597927e-01,-4.4462366855474295e-01,
1.2130985825930876e-02,2.4922494397769116e-02,-1.0083847741560032e-02,-1.4466015698097450e-02,-1.0387984734819765e-02,6.3389379705925264e-01,-8.1200844767128737e-03,-1.5984456884098287e-03,-5.6856641410671079e-04,-3.6059975481208284e-01,-4.8504548009888585e-02,-1.6777524432483842e-01,-8.7897397223270723e-02,-4.4771772328902842e-01,-5.0078175469944108e-01,
1.2137287836361215e-02,8.4292860281497666e-03,-1.3432039062372655e-02,-9.6007816386600060e-03,-9.3596046393179082e-03,6.2908013378977001e-01,-2.2774175317782589e-03,-9.6069051917597806e-03,-2.4615743110527558e-02,-1.6869585923569887e-02,-3.9922910993578664e-01,-2.1178554126355600e-01,-4.2632497791830426e-01,-1.7594856227447092e-01,-5.6520201721559704e-01,
1.2167205319957866e-02,2.8435497692289890e-03,-1.5630757249511164e-02,-1.4067279733618463e-02,-1.2494691537733136e-02,6.2789934417501470e-01,-1.4871411196739830e-02,-1.1520575420738411e-02,-4.5991018124028844e-02,-4.2873778649920619e-01,-4.0868489896978344e-01,-2.6268525642222496e-01,-8.8044302643276035e-02,-1.7834415251908980e-01,-6.0324803438215446e-01,
1.2179967057636172e-02,1.9093169286737498e-03,-1.3222451529190504e-02,-1.4273805827011219e-02,-1.1028249018358454e-02,6.2873586853696883e-01,-2.9147932253252430e-03,-2.3976556675622086e-02,-5.6470872639687360e-03,-2.3949092574415722e-02,-9.0502910447880516e-02,-4.3911226556914223e-01,-5.1738826656581960e-01,-5.2485014924791118e-01,-2.8422661530475390e-01,
1.2208189109145137e-02,3.0859860189596405e-04,-1.4191836650176190e-02,-1.3312162828039263e-02,-1.0519826604816382e-02,6.2952981549902920e-01,-9.6505772543932861e-02,-1.8082446682474751e-01,-1.8102280626472851e-02,-4.6084616145248974e-01,-1.1730288214783169e-01,-4.5008555774574188e-01,-8.9006713156203204e-02,-5.9917340747795955e-01,-2.8807955918285089e-01,
1.2304339678706816e-02,-4.2241684559100743e-04,-1.4470355317322903e-02,-1.0568693036090780e-02,-9.0397287523499483e-03,6.2824284781534123e-01,-3.9114469110755057e-02,-5.2149902430702832e-01,-1.0988731289581730e+00,-4.1158920888088105e-02,-4.8552023590673193e-01,-4.4888195831138150e-01,-5.7823053740232544e-01,-1.8311118045393351e-01,-2.8718624111449848e-01,
1.2393585554336620e-02,-8.1394710067458052e-04,-1.6705351687348970e-02,-1.0967134384938543e-02,-1.3628550845864841e-02,6.2850542869444803e-01,-2.3336078742466138e-01,-2.1926266386355087e-02,-4.3579882623549004e-01,-4.7474251396817879e-01,-5.0672852031150795e-01,-4.9613621155605037e-01,-9.0987550967498845e-02,-1.8537760968206712e-01,-2.8834672421934149e-01,

8,15
7.8386368356335012e-01,1.0551381208261710e+00,1.3583577436807570e-02,1.6167048873278446e-02,1.7709871627103732e-02,1.0674974410636844e+00,1.0114935590054342e-02,1.2216122895083965e-02,9.9218343447605474e-03,3.6771654251825325e-01,4.0438497962440662e-01,4.2467407827759129e-01,1.0630206037288196e-03,4.2088590734951949e-03,2.0186928799650596e-02,
9.4022982473160577e-01,1.0561208989664652e+00,1.8786187146512236e-02,1.9836993352024344e-02,2.1233266758892550e-02,1.0682549299528570e+00,5.2130705159662595e-03,1.5799314539613515e-02,1.0369672104988317e-02,5.6354917017352638e-02,4.2495681611575020e-01,4.6269133307888516e-01,3.4453797295297123e-01,5.8771805682598446e-03,2.8822371188750490e-02,
1.0822872772268273e+00,1.0561033628275718e+00,1.8820169108374959e-02,2.0807840944127437e-02,1.8930469302576750e-02,1.0907165632549771e+00,1.8356359990355800e-02,1.0898818753133754e-02,1.3826952825976811e-02,4.2537586704567176e-01,1.1453623262431306e-01,4.8834277877880439e-01,1.9951051487863175e-03,3.9611089763062390e-01,4.0948041337266483e-02,
1.1846529029769191e+00,1.0557140733426003e+00,1.7283645568534487e-02,2.1171386278569751e-02,2.2195763329652500e-02,1.1874964527461480e+00,1.9880159883285616e-02,1.1820653507242774e-02,1.4260080831291950e-02,5.7449365628676599e-02,1.1556845632856412e-01,4.9579040429154009e-01,4.3463246392574306e-01,4.4369117215433268e-01,5.7934290825518306e-02,
1.2145108255920773e+00,1.0557489663779605e+00,1.7938033505965033e-02,1.6287796765266864e-02,2.2151774757532820e-02,1.2164201425207510e+00,2.0689811148436876e-02,1.3901981018202496e-02,1.3047179589468339e-02,4.6445079082714047e-01,4.7119443579371734e-01,1.8182213823993082e-01,2.9143928018616353e-03,1.2144883351511451e-02,4.6736634381058795e-01,
1.2621404328392811e+00,1.0553454660188859e+00,1.7010921908931532e-02,1.6903343882588767e-02,2.1511243771023619e-02,1.2624490314411771e+00,1.2170106827106904e-01,1.3679596728743488e-02,5.6856197055174029e-02,5.7806961747355820e-02,5.0746335788066999e-01,1.8182302987848581e-01,5.1974396809720536e-01,1.7049485672476959e-02,5.1635241215975392e-01,
1.2830134451907020e+00,1.0544662928077202e+00,1.9332743029431172e-02,2.1262299471973136e-02,2.2016642882777420e-02,1.2825910283451110e+00,6.1755406895839013e-02,3.9523076106269220e-02,4.7326533213152625e-02,4.7477246401892731e-01,1.1711717305236971e-01,1.8270792843043115e-01,5.5646087024581892e-03,5.5274827720831765e-01,5.3954432746924741e-01,
1.2913146261412849e+00,1.0529677800060808e+00,1.8245168768743665e-02,2.0394874314691142e-02,2.2243897631092760e-02,1.2905165105550713e+00,7.8391006587724854e-02,4.6137741029114498e-01,2.6841398256901694e-01,5.8408117032598461e-02,1.1811995226758568e-01,1.8393763992908044e-01,5.6343948896038309e-01,6.0919770932022421e-01,5.7795291862820886e-01,

