1
1
15
0
(8 0
((0,0,0) (7,7,7) (0,0,0))
((8,0,0) (15,7,7) (0,0,0))
((0,8,0) (7,15,7) (0,0,0))
((8,8,0) (15,15,7) (0,0,0))
((0,0,8) (7,7,15) (0,0,0))
((8,0,8) (15,7,15) (0,0,0))
((0,8,8) (7,15,15) (0,0,0))
((8,8,8) (15,15,15) (0,0,0))
)
8
FabOnDisk: Cell_D_00000 0
FabOnDisk: Cell_D_00000 61527
FabOnDisk: Cell_D_00000 123055
FabOnDisk: Cell_D_00000 184583
FabOnDisk: Cell_D_00000 246112
FabOnDisk: Cell_D_00000 307640
FabOnDisk: Cell_D_00000 369169
FabOnDisk: Cell_D_00000 430698

8,15
1.23637387153776312e-02,5.29157460197385437e-02,-1.49805784472397709e-02,-1.44334908350769973e-02,-1.08620188353596488e-02,6.35128781459816771e-01,-2.73374671114236419e-03,-1.31041395436443326e-03,5.73103806083820832e-05,-9.85784261182339264e-03,-3.62537115912872424e-02,-1.27990499826209164e-01,-3.53002180673871013e-01,-3.95787229705725219e-01,-4.42030011667450984e-01,
1.21326203693645548e-02,2.25192935646910813e-02,-1.01352217091593838e-02,-1.46176291947129854e-02,-1.03502958465645743e-02,6.31757179091765542e-01,-8.49512234523754767e-03,-1.66601456202626987e-03,-7.96338004406694361e-04,-3.61215181797485185e-01,-4.79088128012374326e-02,-1.63270480743114926e-01,-8.78659531703659125e-02,-4.51379065252588474e-01,-5.06097830426928574e-01,
1.21391793936680738e-02,7.80182147343926307e-03,-1.36787886013689346e-02,-9.75530989709852588e-03,-9.31587296992695928e-03,6.28910891782241688e-01,-2.19475484862075281e-03,-9.50608251286267497e-03,-2.66497595164785252e-02,-1.72086178227153219e-02,-4.01093395815885767e-01,-2.05030204474903499e-01,-4.31291098952328478e-01,-1.73844641702191272e-01,-5.65810550928739442e-01,
1.21702803055866345e-02,2.63684221562278170e-03,-1.54926180655025926e-02,-1.37647730600000354e-02,-1.26188160251490024e-02,6.27896125563240926e-01,-1.48225831742500001e-02,-1.11106032898991951e-02,-4.47516621259362035e-02,-4.31163349425196796e-01,-4.10520111658045361e-01,-2.54795279554914988e-01,-8.87719894176434432e-02,-1.76167975466418048e-01,-6.00822499504276242e-01,
1.21858765967961715e-02,1.85540452567912648e-03,-1.32388705267169719e-02,-1.43520448051880339e-02,-1.08524458628940675e-02,6.28778632862040499e-01,-2.96720405488516909e-03,-2.37126815819293651e-02,-7.17800784669377339e-03,-2.41245509054003500e-02,-8.76341523194382466e-02,-4.40576893267754954e-01,-5.18986818629247115e-01,-5.27317744371729180e-01,-2.80235583756532292e-01,
1.22138110694678479e-02,2.72043359129586066e-04,-1.42288786108339498e-02,-1.34099610758585709e-02,-1.05619706231486043e-02,6.29396460184096229e-01,-1.02388975991449971e-01,-2.10930533535572340e-01,-2.33871327350131178e-02,-4.61207413555746792e-01,-1.13730359534082837e-01,-4.52923129302299499e-01,-8.92031803191579986e-02,-6.00420921802248708e-01,-2.83452107942612386e-01,
1.23055688680177473e-02,-4.23748302123337953e-04,-1.43287106889163282e-02,-1.05705174025401659e-02,-9.16374554500340444e-03,6.27820055741654226e-01,-6.74075704341688509e-01,-1.17876065397492225e+00,-2.16745021398588911e+00,-4.11003451455921112e-02,-4.84561232624457605e-01,-4.52459216018541999e-01,-5.78239624781512362e-01,-1.80069745647194163e-01,-2.82661464951854624e-01,
1.23928522919494674e-02,-8.07310890110532042e-04,-1.66513005215585090e-02,-1.13623908644407273e-02,-1.36138770986936521e-02,6.28179085692958994e-01,-6.68656379658850164e-02,-2.10155357631275422e-02,-1.16563186386953468e-01,-4.74512574764581141e-01,-5.07370910725631563e-01,-4.92879009019470182e-01,-9.06763484108192019e-02,-1.82285046274436091e-01,-2.83498347448065346e-01,

8,15
8.00320191318909746e-01,1.05511835081889127e+00,1.35904985327914667e-02,1.58442522371460455e-02,1.78346489302558323e-02,1.06748208953426893e+00,1.04808176664966703e-02,1.25391324132372896e-02,9.94401435448168634e-03,3.68832804283613314e-01,4.06055935987806926e-01,4.28568662235615516e-01,1.09383307024835900e-03,4.14557063361115953e-03,1.93235610572062080e-02,
9.56164713214931905e-01,1.05610751618210696e+00,1.86303851184018744e-02,1.96602171202206986e-02,2.12023614183430749e-02,1.06824487321045192e+00,5.39985990618357774e-03,1.54038881020872008e-02,1.02463890896762628e-02,5.66318689965116251e-02,4.24671122757098951e-01,4.64896715624789736e-01,3.49095768924336136e-01,5.79811580202270645e-03,2.75569244410503768e-02,
1.09073564798994349e+00,1.05611648652883972e+00,1.86774651253242031e-02,2.10935411760972344e-02,1.89082077363642367e-02,1.09853746946338271e+00,1.72912922978638375e-02,1.03588372334207160e-02,1.39463178910295433e-02,4.27871755447311319e-01,1.12259323897654695e-01,4.87416773641167256e-01,2.03994735500824705e-03,3.99553542425729769e-01,3.87243293708572078e-02,
1.19066553793957075e+00,1.05574453115893530e+00,1.73872700583440343e-02,2.13819086468711034e-02,2.21648261803476451e-02,1.19330238015519363e+00,2.03178816547658868e-02,1.11478169135548876e-02,1.42559416663223491e-02,5.76369213078098963e-02,1.13981752027991351e-01,4.92581624028021636e-01,4.39824394196498547e-01,4.47302092718598054e-01,5.47456040581855777e-02,
1.21640160607406878e+00,1.05572584136303238e+00,1.79056169705393842e-02,1.62358729352391727e-02,2.18831281914891630e-02,1.21825701059974789e+00,2.09244576110655042e-02,1.39938262981211745e-02,1.50492985199039350e-02,4.64982517828433306e-01,4.72776371285005936e-01,1.78698329000067657e-01,2.93738996821506140e-03,1.16837128796369628e-02,4.68529916716736605e-01,
1.26309272497317804e+00,1.05532644700728828e+00,1.70042530586059192e-02,1.69730816544325439e-02,2.12420743653769367e-02,1.26336476833230771e+00,1.28909567196969499e-01,1.37943326586329410e-02,6.31526497391227126e-02,5.76299411331308020e-02,5.07902035425917942e-01,1.78478969127224441e-01,5.21234762209433655e-01,1.64043586292690613e-02,5.18864120522799177e-01,
1.28234026647448141e+00,1.05446732842592206e+00,1.92561962148400309e-02,2.14997851597222671e-02,2.17370843059139229e-02,1.28191651817235797e+00,6.14255131219518247e-02,1.01540294841913487e-01,1.23343202907398330e+00,4.74591818193690174e-01,1.15117481175816133e-01,1.80033586023921277e-01,5.55537370403449710e-03,5.50352875341320047e-01,5.43724783820845214e-01,
1.29138956713553021e+00,1.05301682718362000e+00,1.80463398958957688e-02,2.06598603988915538e-02,2.19966232926662418e-02,1.29058225624541967e+00,1.42885008014178805e-01,4.50907429722937292e-01,2.56956858853545578e-01,5.83779254606434997e-02,1.16137057924974821e-01,1.80839507211602052e-01,5.63498998461472000e-01,6.08864219715706145e-01,5.72850165018849555e-01,

