1
1
15
0
(8 0
((0,0,0) (7,7,7) (0,0,0))
((8,0,0) (15,7,7) (0,0,0))
((0,8,0) (7,15,7) (0,0,0))
((8,8,0) (15,15,7) (0,0,0))
((0,0,8) (7,7,15) (0,0,0))
((8,0,8) (15,7,15) (0,0,0))
((0,8,8) (7,15,15) (0,0,0))
((8,8,8) (15,15,15) (0,0,0))
)
8
FabOnDisk: Cell_D_00000 0
FabOnDisk: Cell_D_00000 61527
FabOnDisk: Cell_D_00000 123055
FabOnDisk: Cell_D_00000 184583
FabOnDisk: Cell_D_00000 246112
FabOnDisk: Cell_D_00000 307640
FabOnDisk: Cell_D_00000 369169
FabOnDisk: Cell_D_00000 430698

8,15
1.23593202375132955e-02,5.71935573150003373e-02,-1.50661225950677151e-02,-1.42721389813782653e-02,-1.08704550147044887e-02,6.34490718461514946e-01,-2.77571292708704001e-03,-1.41949837613020722e-03,2.88251849555928917e-04,-9.57708603030136586e-03,-3.67394087831791963e-02,-1.31618537899193061e-01,-3.48170855170153559e-01,-3.90805063495979266e-01,-4.44623668554742946e-01,
1.21309858259308762e-02,2.49224943977691162e-02,-1.00838477415600321e-02,-1.44660156980974501e-02,-1.03879847348197652e-02,6.33893797059252639e-01,-8.12008447671287367e-03,-1.59844568840982870e-03,-5.68566414106710786e-04,-3.60599754812082840e-01,-4.85045480098885845e-02,-1.67775244324838424e-01,-8.78973972232707235e-02,-4.47717723289028424e-01,-5.00781754699441084e-01,
1.21372878363612147e-02,8.42928602814976662e-03,-1.34320390623726554e-02,-9.60078163866000603e-03,-9.35960463931790818e-03,6.29080133789770013e-01,-2.27741753177825891e-03,-9.60690519175978058e-03,-2.46157431105275583e-02,-1.68695859235698867e-02,-3.99229109935786641e-01,-2.11785541263556004e-01,-4.26324977918304260e-01,-1.75948562274470921e-01,-5.65202017215597041e-01,
1.21672053199578661e-02,2.84354976922898900e-03,-1.56307572495111638e-02,-1.40672797336184631e-02,-1.24946915377331363e-02,6.27899344175014695e-01,-1.48714111967398303e-02,-1.15205754207384110e-02,-4.59910181240288443e-02,-4.28737786499206186e-01,-4.08684898969783439e-01,-2.62685256422224955e-01,-8.80443026432760345e-02,-1.78344152519089805e-01,-6.03248034382154463e-01,
1.21799670576361718e-02,1.90931692867374976e-03,-1.32224515291905036e-02,-1.42738058270112187e-02,-1.10282490183584540e-02,6.28735868536968834e-01,-2.91479322532524300e-03,-2.39765566756220856e-02,-5.64708726396873605e-03,-2.39490925744157215e-02,-9.05029104478805163e-02,-4.39112265569142235e-01,-5.17388266565819599e-01,-5.24850149247911180e-01,-2.84226615304753905e-01,
1.22081891091451369e-02,3.08598601895964048e-04,-1.41918366501761900e-02,-1.33121628280392628e-02,-1.05198266048163822e-02,6.29529815499029199e-01,-9.65057725439328606e-02,-1.80824466824747510e-01,-1.81022806264728511e-02,-4.60846161452489744e-01,-1.17302882147831689e-01,-4.50085557745741882e-01,-8.90067131562032043e-02,-5.99173407477959552e-01,-2.88079559182850886e-01,
1.23043396787068157e-02,-4.22416845591007427e-04,-1.44703553173229030e-02,-1.05686930360907802e-02,-9.03972875234994831e-03,6.28242847815341232e-01,-3.91144691107550568e-02,-5.21499024307028325e-01,-1.09887312895817302e+00,-4.11589208880881047e-02,-4.85520235906731934e-01,-4.48881958311381501e-01,-5.78230537402325440e-01,-1.83111180453933514e-01,-2.87186241114498475e-01,
1.23935855543366204e-02,-8.13947100674580521e-04,-1.67053516873489696e-02,-1.09671343849385428e-02,-1.36285508458648414e-02,6.28505428694448032e-01,-2.33360787424661376e-01,-2.19262663863550866e-02,-4.35798826235490044e-01,-4.74742513968178792e-01,-5.06728520311507946e-01,-4.96136211556050366e-01,-9.09875509674988453e-02,-1.85377609682067124e-01,-2.88346724219341488e-01,

8,15
7.83863683563350122e-01,1.05513812082617098e+00,1.35835774368075705e-02,1.61670488732784459e-02,1.77098716271037321e-02,1.06749744106368438e+00,1.01149355900543424e-02,1.22161228950839647e-02,9.92183434476054740e-03,3.67716542518253253e-01,4.04384979624406615e-01,4.24674078277591294e-01,1.06302060372881957e-03,4.20885907349519486e-03,2.01869287996505956e-02,
9.40229824731605768e-01,1.05612089896646522e+00,1.87861871465122357e-02,1.98369933520243444e-02,2.12332667588925501e-02,1.06825492995285698e+00,5.21307051596625950e-03,1.57993145396135154e-02,1.03696721049883166e-02,5.63549170173526376e-02,4.24956816115750202e-01,4.62691333078885159e-01,3.44537972952971228e-01,5.87718056825984464e-03,2.88223711887504903e-02,
1.08228727722682727e+00,1.05610336282757178e+00,1.88201691083749595e-02,2.08078409441274370e-02,1.89304693025767502e-02,1.09071656325497712e+00,1.83563599903558000e-02,1.08988187531337544e-02,1.38269528259768112e-02,4.25375867045671763e-01,1.14536232624313061e-01,4.88342778778804387e-01,1.99510514878631752e-03,3.96110897630623904e-01,4.09480413372664831e-02,
1.18465290297691905e+00,1.05571407334260026e+00,1.72836455685344871e-02,2.11713862785697510e-02,2.21957633296525000e-02,1.18749645274614801e+00,1.98801598832856162e-02,1.18206535072427742e-02,1.42600808312919498e-02,5.74493656286765991e-02,1.15568456328564120e-01,4.95790404291540088e-01,4.34632463925743062e-01,4.43691172154332680e-01,5.79342908255183059e-02,
1.21451082559207735e+00,1.05574896637796045e+00,1.79380335059650328e-02,1.62877967652668640e-02,2.21517747575328203e-02,1.21642014252075104e+00,2.06898111484368763e-02,1.39019810182024958e-02,1.30471795894683395e-02,4.64450790827140469e-01,4.71194435793717337e-01,1.81822138239930819e-01,2.91439280186163528e-03,1.21448833515114506e-02,4.67366343810587948e-01,
1.26214043283928112e+00,1.05534546601888590e+00,1.70109219089315325e-02,1.69033438825887672e-02,2.15112437710236193e-02,1.26244903144117715e+00,1.21701068271069038e-01,1.36795967287434879e-02,5.68561970551740292e-02,5.78069617473558200e-02,5.07463357880669985e-01,1.81823029878485809e-01,5.19743968097205356e-01,1.70494856724769592e-02,5.16352412159753915e-01,
1.28301344519070204e+00,1.05446629280772020e+00,1.93327430294311722e-02,2.12622994719731361e-02,2.20166428827774201e-02,1.28259102834511096e+00,6.17554068958390129e-02,3.95230761062692199e-02,4.73265332131526245e-02,4.74772464018927309e-01,1.17117173052369711e-01,1.82707928430431155e-01,5.56460870245818924e-03,5.52748277208317651e-01,5.39544327469247409e-01,
1.29131462614128489e+00,1.05296778000608082e+00,1.82451687687436651e-02,2.03948743146911415e-02,2.22438976310927600e-02,1.29051651055507133e+00,7.83910065877248541e-02,4.61377410291144985e-01,2.68413982569016940e-01,5.84081170325984611e-02,1.18119952267585676e-01,1.83937639929080438e-01,5.63439488960383095e-01,6.09197709320224212e-01,5.77952918628208856e-01,

