1
1
15
0
(8 0
((0,0,0) (7,7,7) (0,0,0))
((8,0,0) (15,7,7) (0,0,0))
((0,8,0) (7,15,7) (0,0,0))
((8,8,0) (15,15,7) (0,0,0))
((0,0,8) (7,7,15) (0,0,0))
((8,0,8) (15,7,15) (0,0,0))
((0,8,8) (7,15,15) (0,0,0))
((8,8,8) (15,15,15) (0,0,0))
)
8
FabOnDisk: Cell_D_00000 0
FabOnDisk: Cell_D_00000 61527
FabOnDisk: Cell_D_00000 123055
FabOnDisk: Cell_D_00000 184583
FabOnDisk: Cell_D_00000 246112
FabOnDisk: Cell_D_00000 307640
FabOnDisk: Cell_D_00000 369169
FabOnDisk: Cell_D_00000 430698

8,15
1.23573863706571592e-02,4.38766864588020916e-02,-1.50100984253405661e-02,-1.55358494083780944e-02,-1.13442324086273257e-02,6.30646998013433047e-01,-2.40293593833979663e-03,-1.58123936862605537e-03,-5.23590486280570058e-04,-9.70536450191961109e-03,-3.82041985992173788e-02,-1.16883438792646149e-01,-3.61043958364688389e-01,-4.09665663416917236e-01,-4.47125495275982887e-01,
1.21372397299674816e-02,1.87374897440931651e-02,-9.98279458403537011e-03,-1.55155980536235746e-02,-1.10479556080322720e-02,6.29987429323284553e-01,-8.93774531320196478e-03,-1.21908678034608970e-03,-1.28977455511084709e-03,-3.64592201740435162e-01,-4.97775224312202794e-02,-1.48156085369132384e-01,-8.24578627819896465e-02,-4.60043823170163402e-01,-5.12152639394506282e-01,
1.21372287432095043e-02,6.01766905397208528e-03,-1.35942199782628590e-02,-9.88944628857345992e-03,-9.98469839271631972e-03,6.27983654902770305e-01,-1.82660423372287906e-03,-1.00682460224674804e-02,-3.47632249372319679e-02,-1.69034040334972886e-02,-4.04914479697513818e-01,-1.88628826357462254e-01,-4.47881541720915211e-01,-1.75380225953839203e-01,-5.67557287214450312e-01,
1.21681569298980816e-02,2.19220735098817412e-03,-1.49144018485550863e-02,-1.32390113518194592e-02,-1.26454086990203229e-02,6.28040395901191650e-01,-1.70440033323715975e-02,-9.85236123875401354e-03,-4.66236703387733972e-02,-4.36301538251840315e-01,-4.11043327832491034e-01,-2.33601350432278032e-01,-8.49149798379375681e-02,-1.76453510186888096e-01,-5.91698743648863879e-01,
1.21893321007617069e-02,1.81865110861758380e-03,-1.38114673644543391e-02,-1.50604112671618579e-02,-1.04501241424662366e-02,6.28417281413896855e-01,-2.93082846187377654e-03,-2.46961192966865667e-02,-6.84871253734232240e-03,-2.25160816625308464e-02,-8.72528033925049212e-02,-4.42364785390471860e-01,-5.18981227625869623e-01,-5.29073777329594708e-01,-2.68218460386317137e-01,
1.22170744782065955e-02,3.15693862602796295e-04,-1.42040046175141953e-02,-1.43938332480176723e-02,-1.06293723050439846e-02,6.28709340831593133e-01,-8.40767906588253261e-02,-1.73067429753341551e-01,-2.53648925202742820e-02,-4.62251239147043136e-01,-1.11839623520883252e-01,-4.58809317707537689e-01,-8.46871771843286381e-02,-5.98522796133012847e-01,-2.70261643353927661e-01,
1.23090761735725699e-02,-4.23056385672710886e-04,-1.36213690058766407e-02,-1.01200186613250621e-02,-9.65914801602720668e-03,6.28439989138260380e-01,-9.69845731255320476e-02,-2.12899413281870536e-02,-1.93227854128191698e-02,-3.82737402841876531e-02,-4.84790633602808940e-01,-4.60998389891417282e-01,-5.73895891774298117e-01,-1.79706848545163000e-01,-2.69483062458327982e-01,
1.23917059065351883e-02,-7.67962625302477404e-04,-1.65096058630483308e-02,-1.20224232993867697e-02,-1.34110808917581523e-02,6.27699548846186284e-01,-7.20609552720395063e-01,-1.70276518804167776e-01,-5.19390318482596758e-01,-4.68846282943034931e-01,-5.07044785682404187e-01,-4.81960895251944965e-01,-8.69302123329909887e-02,-1.81227933794277540e-01,-2.70623224178681232e-01,

8,15
8.38419117393153224e-01,1.05515048142748125e+00,1.35320790548911617e-02,1.55892489571892081e-02,1.79960587020817596e-02,1.06750786779813844e+00,1.09695834957638447e-02,1.22138269021828706e-02,9.64081997392955518e-03,3.68275554734145527e-01,4.11450452943719347e-01,4.36188688953417669e-01,1.07610658598004711e-03,4.38406185535861366e-03,1.68935283502155004e-02,
9.83650310718066301e-01,1.05610448536342894e+00,1.84445678220517342e-02,1.83142848544688014e-02,2.09931086236411109e-02,1.06824943903714908e+00,5.63853035375455006e-03,1.25871496051730963e-02,9.99040384056005225e-03,5.38370880846473637e-02,4.26086873420900958e-01,4.66287334011114440e-01,3.58701728806909537e-01,6.04002172873249494e-03,2.37016895633094700e-02,
1.11776040798437792e+00,1.05608702608740113e+00,1.80299297736396733e-02,2.13648297937592581e-02,1.89232181625397719e-02,1.12377807703835009e+00,1.54022529308581423e-02,9.80701944190387476e-03,1.36484539947905967e-02,4.35883682531137462e-01,1.11644855970493798e-01,4.83636292449179106e-01,2.00720403632201685e-03,4.11828173721266233e-01,3.36720158018021104e-02,
1.20455573468952060e+00,1.05570506043280021e+00,1.73146130438369406e-02,2.15038171583049227e-02,2.18538665283947442e-02,1.20674794204050873e+00,2.22399350164516410e-02,1.06249449067793069e-02,1.42823399361054881e-02,5.46505508321517910e-02,1.13909530850793778e-01,4.85390376813864655e-01,4.50543651061654615e-01,4.54566115163783757e-01,4.68959862545377526e-02,
1.21772371543950975e+00,1.05571294048564579e+00,1.76476243933071167e-02,1.63070593376010986e-02,2.16030603597998430e-02,1.21954236654812731e+00,2.06264177388471408e-02,1.31340586575720009e-02,1.49947897862008489e-02,4.63970046125747659e-01,4.73728935129714313e-01,1.69867904332940134e-01,2.73518517803512115e-03,1.16167887819230743e-02,4.67382640952780037e-01,
1.26235576126224602e+00,1.05532672673175831e+00,1.75139328966000679e-02,1.74570235937057880e-02,2.13027131585098277e-02,1.26267145512484880e+00,1.16609457503951963e-01,1.39923335777853777e-02,6.02547286363979834e-02,5.48694939694296946e-02,5.07023132224372564e-01,1.70488028181699752e-01,5.20069239422206842e-01,1.60438443688190359e-02,5.20094566175359652e-01,
1.28261541239286725e+00,1.05446205156938277e+00,1.92079902587773757e-02,2.15718869066474223e-02,2.17665375405656017e-02,1.28219235600719461e+00,5.85896647383610802e-02,4.09158659213839787e-02,2.31267274540309986e-01,4.72567014389299767e-01,1.14655792926324968e-01,1.72166613385318412e-01,5.16113827238545448e-03,5.50811553619078964e-01,5.53320375308447909e-01,
1.29162770316465125e+00,1.05310305720120612e+00,1.78056124317805611e-02,2.09726514897019788e-02,2.17646102386893948e-02,1.29085974053934871e+00,1.76788561076997947e-01,9.56940566824448613e-01,4.91459433791066602e-01,5.58036984459453836e-02,1.15625085270584821e-01,1.72813451175575505e-01,5.67324727497955594e-01,6.07159796252355610e-01,5.56288051617139900e-01,

