1
1
15
0
(8 0
((0,0,0) (7,7,7) (0,0,0))
((8,0,0) (15,7,7) (0,0,0))
((0,8,0) (7,15,7) (0,0,0))
((8,8,0) (15,15,7) (0,0,0))
((0,0,8) (7,7,15) (0,0,0))
((8,0,8) (15,7,15) (0,0,0))
((0,8,8) (7,15,15) (0,0,0))
((8,8,8) (15,15,15) (0,0,0))
)
8
FabOnDisk: Cell_D_00000 0
FabOnDisk: Cell_D_00000 61527
FabOnDisk: Cell_D_00000 123055
FabOnDisk: Cell_D_00000 184583
FabOnDisk: Cell_D_00000 246112
FabOnDisk: Cell_D_00000 307640
FabOnDisk: Cell_D_00000 369169
FabOnDisk: Cell_D_00000 430698

8,15
1.23959581406860603e-02,8.13930843214258626e-02,-1.53422923316525409e-02,-1.37904721092844771e-02,-1.27795688760318771e-02,6.31081926640043811e-01,-2.88128788681341931e-03,-2.16811984275149276e-03,-6.17213265876430926e-04,-9.36460176385398892e-03,-3.84219344987121875e-02,-1.45402983614363934e-01,-3.26396286904468980e-01,-3.63124284370741068e-01,-4.48939847016559312e-01,
1.21526063740785822e-02,3.67141455002272382e-02,-9.95401908378301670e-03,-1.45140624625122016e-02,-1.21906418470491430e-02,6.31299869569745042e-01,-6.41311234850481301e-03,-1.91411079507201182e-03,-7.62059425239073706e-04,-3.53358931528709119e-01,-5.17200363931761067e-02,-1.87450854081406160e-01,-9.53608284199575912e-02,-4.29931021867280827e-01,-4.75897766228167263e-01,
1.21607454218902230e-02,1.25596960286251235e-02,-1.32568723976784642e-02,-1.06679871581803302e-02,-1.14901635373336284e-02,6.29843760618091442e-01,-3.02901044418548218e-03,-9.56232785736499565e-03,-1.39108035132306396e-02,-1.70995063682393492e-02,-3.89809230200335088e-01,-2.37864365099131281e-01,-4.15301093695541967e-01,-1.92778225527320185e-01,-5.54628344833003606e-01,
1.21934100449224477e-02,3.83561453353156679e-03,-1.64897137295761283e-02,-1.54982634039766767e-02,-1.31336532608374267e-02,6.27875750971638280e-01,-1.87329948866936970e-02,-1.42202907464074341e-02,-5.23127857907334376e-02,-4.20428802865692508e-01,-4.00156290290349770e-01,-2.96295643415496524e-01,-9.50055174873406100e-02,-1.91592681174833412e-01,-6.09648626214630784e-01,
1.21818361250795541e-02,2.31813207524791606e-03,-1.33680264212006419e-02,-1.46644638496550815e-02,-1.35084464726610964e-02,6.28740284321112730e-01,-2.90876838961138563e-03,-3.09929685020161605e-02,-4.97574607352863161e-03,-2.53114785524638300e-02,-1.01680461289256036e-01,-4.30643708014132653e-01,-5.07517925611451037e-01,-5.21277033089000530e-01,-2.97016073333366548e-01,
1.22150135553152350e-02,4.53639294230159373e-04,-1.44409729070246254e-02,-1.33096304119674231e-02,-1.25548218372084509e-02,6.28882795407436190e-01,-7.44718471210519262e-02,-1.10198970714544695e-01,-1.78104634999558392e-02,-4.57433408727829172e-01,-1.33701815798268508e-01,-4.37214033362093080e-01,-9.59847553989764402e-02,-5.93044768794863120e-01,-3.04914424298610431e-01,
1.23191196383776024e-02,-4.50741483465976508e-04,-1.52146941405010561e-02,-1.23246014909449714e-02,-1.16907164102058175e-02,6.29849809504435587e-01,-3.72833549378305262e-02,-2.38192951879174636e-02,-2.45729904881640086e-02,-4.50508348200831660e-02,-4.86097933541950911e-01,-4.62259458889228370e-01,-5.85022873904760266e-01,-1.95210730629993973e-01,-3.04868490571582218e-01,
1.24341345544062946e-02,-8.42330597126001281e-04,-1.70912083723938728e-02,-1.26096708145897983e-02,-1.47172067807233679e-02,6.29012992476120081e-01,-9.25150035040977203e-02,-9.24289500365248373e-01,-1.93959715258906140e+00,-4.81228086895209128e-01,-5.02045577196987614e-01,-5.06167166061147089e-01,-9.77355065353128216e-02,-1.97914544565745587e-01,-3.06221036442430372e-01,

8,15
7.03458448241344403e-01,1.05496770097535641e+00,1.26887210871413983e-02,1.56037459137630223e-02,1.58204971134996500e-02,1.06736365911604247e+00,7.72585223744165668e-03,1.00927284217714984e-02,8.58761128515568573e-03,3.62848119675778125e-01,3.91738320056619183e-01,4.03084942447952455e-01,1.03870840011820826e-03,4.42431387101241847e-03,2.37793160958198226e-02,
8.74027117369602369e-01,1.05604386805601269e+00,1.83251686661112800e-02,1.94344716520039248e-02,1.98479681264957589e-02,1.06821513200317297e+00,4.90367217326516391e-03,1.58089677797626227e-02,9.24735380750607398e-03,5.97857697120609960e-02,4.22503445254112431e-01,4.49697698307034099e-01,3.23238349907112810e-01,6.32214643953001466e-03,3.48605512573436291e-02,
1.03555875047176027e+00,1.05602826037088571e+00,1.84664146724848287e-02,1.82801925588774103e-02,1.78705562034429943e-02,1.06818909022165753e+00,2.07654010479613044e-02,1.15448960797029446e-02,1.21179479037640467e-02,4.10452770254946642e-01,1.23657068377129378e-01,4.86751723323649577e-01,2.01165237175543856e-03,3.77891394697933092e-01,5.05796198510599093e-02,
1.15890455268471060e+00,1.05560161984074696e+00,1.58352090818762621e-02,1.90467145720392902e-02,2.06347103066766430e-02,1.16274016721824225e+00,1.92271871097017058e-02,1.53391466356468855e-02,1.25871814286432279e-02,6.17781687386145320e-02,1.23565014733820103e-01,5.05354299957133213e-01,4.17663456761778185e-01,4.29174893344067443e-01,7.32533752471359184e-02,
1.20087408585160604e+00,1.05582515219235162e+00,1.75566108617962041e-02,1.64161085970062279e-02,2.13709993551041942e-02,1.20319221792685394e+00,1.83649312365432513e-02,1.37524764784837453e-02,1.06237402585912279e-02,4.62170154358280016e-01,4.60169111695238997e-01,1.93517879282146060e-01,3.07115228628397283e-03,1.40167510473655308e-02,4.57739930365821168e-01,
1.25814197224690028e+00,1.05538656968865063e+00,1.62081684144964010e-02,1.67393068955360193e-02,2.03942380735179819e-02,1.25859561154113053e+00,8.23347209683290282e-02,1.36767131713873436e-02,3.57809114120093696e-02,6.19751459333141436e-02,5.04398903652192421e-01,1.94069342909247822e-01,5.13702684009880617e-01,2.02115013419784592e-02,5.04775464386327477e-01,
1.28265509847065706e+00,1.05446343768621742e+00,1.88547111049050149e-02,1.93932665854218943e-02,2.07107242159210586e-02,1.28220435698719104e+00,5.29232856342696789e-02,9.74503563582821003e-02,4.42178038461854828e-02,4.79549745047811060e-01,1.25042371172103844e-01,1.92964267635832992e-01,6.09438373610865242e-03,5.56439782042221331e-01,5.20078700709220354e-01,
1.29133629144095075e+00,1.05268888129052729e+00,1.81225708818632952e-02,1.79645031769410102e-02,2.12171096429963624e-02,1.29060198684841398e+00,8.59239070127401638e-01,3.77801182145156567e-01,1.76456394492138346e-01,6.26042768808295208e-02,1.25541143173250380e-01,1.95220717725733489e-01,5.58235440044219433e-01,6.08470606743127806e-01,5.95674112042961612e-01,

