1
1
15
0
(8 0
((0,0,0) (7,7,7) (0,0,0))
((8,0,0) (15,7,7) (0,0,0))
((0,8,0) (7,15,7) (0,0,0))
((8,8,0) (15,15,7) (0,0,0))
((0,0,8) (7,7,15) (0,0,0))
((8,0,8) (15,7,15) (0,0,0))
((0,8,8) (7,15,15) (0,0,0))
((8,8,8) (15,15,15) (0,0,0))
)
8
FabOnDisk: Cell_D_00000 0
FabOnDisk: Cell_D_00000 61527
FabOnDisk: Cell_D_00000 123055
FabOnDisk: Cell_D_00000 184583
FabOnDisk: Cell_D_00000 246112
FabOnDisk: Cell_D_00000 307640
FabOnDisk: Cell_D_00000 369169
FabOnDisk: Cell_D_00000 430698

8,15
1.23967214892296736e-02,7.54091717283312396e-02,-1.54375840745949768e-02,-1.40757703940363813e-02,-1.27898469983793971e-02,6.30852578945442888e-01,-2.90449326764497494e-03,-1.93258890411927516e-03,-7.22572291856527871e-04,-9.63918023462234652e-03,-3.79043470768049562e-02,-1.41590623780279895e-01,-3.32292617533861301e-01,-3.69527967478229080e-01,-4.47956023193695096e-01,
1.21534624734356365e-02,3.32126418556537711e-02,-1.01150881552072355e-02,-1.47583877318147212e-02,-1.21125556714514609e-02,6.32101127172393529e-01,-6.87678829319352848e-03,-1.99277694221925740e-03,-1.02751349065038607e-03,-3.54611183631920845e-01,-5.10397211100233616e-02,-1.82809867690508027e-01,-9.53956624979845486e-02,-4.35218670612482095e-01,-4.83035822978605145e-01,
1.21603338035607116e-02,1.15282156065684357e-02,-1.34130067254646518e-02,-1.05944932590027619e-02,-1.14272919127009296e-02,6.29999024200788904e-01,-2.91351619395637928e-03,-9.75848825017961059e-03,-1.60167366169225167e-02,-1.74476564451821470e-02,-3.91940389736278205e-01,-2.30726092209625061e-01,-4.17205984469676605e-01,-1.88848037361117771e-01,-5.56967804515136056e-01,
1.21932608789372850e-02,3.51996781221717561e-03,-1.64747465200253060e-02,-1.53035713103326053e-02,-1.33590609834154835e-02,6.27868765164998344e-01,-1.79269147087286335e-02,-1.36469022537097501e-02,-5.11390227893249033e-02,-4.23114115395653967e-01,-4.02227470308561375e-01,-2.88222044891691398e-01,-9.48528026909097599e-02,-1.87358483850191215e-01,-6.08635601704844653e-01,
1.21838067792264335e-02,2.24492168031943879e-03,-1.34496807533835208e-02,-1.48310873662091027e-02,-1.33206736913026244e-02,6.28631428411510429e-01,-2.97693454139749594e-03,-3.03060264726467306e-02,-5.39407887543665813e-03,-2.55318270098769187e-02,-9.84345914279109169e-02,-4.32543371544884814e-01,-5.09635737657356813e-01,-5.18010727815761962e-01,-2.93728398960846460e-01,
1.22171979755414349e-02,4.06810743041410101e-04,-1.44874375534952866e-02,-1.35477244714334380e-02,-1.23082219795044960e-02,6.29026151373101472e-01,-8.07259912504928318e-02,-1.28686232329248307e-01,-1.85368498313372154e-02,-4.57838675500924608e-01,-1.29585771591047116e-01,-4.40415755303760204e-01,-9.58675895901658498e-02,-5.95144771965828046e-01,-3.00910715062417178e-01,
1.23170154725276322e-02,-4.42916011002672744e-04,-1.51912409401430450e-02,-1.23248093506006171e-02,-1.13955124723585949e-02,6.29974409795395651e-01,-3.73398331855339105e-02,-2.32040838303378405e-02,-5.78882788106488619e-02,-4.50409301857511296e-02,-4.85740830142760371e-01,-4.58502684889743328e-01,-5.84998045274583545e-01,-1.92009810947765425e-01,-3.00153887621774640e-01,
1.24285838278354200e-02,-8.42966223265699337e-04,-1.71174734503567148e-02,-1.25249712105070174e-02,-1.48050481735719636e-02,6.29072003106973865e-01,-6.25628309755522083e-02,-6.04924411439709431e+00,-1.08437133626367626e+01,-4.81180539134101193e-01,-5.03539227489250507e-01,-5.04251672781894644e-01,-9.77594063605876640e-02,-1.94725532702976711e-01,-3.01474175566289859e-01,

8,15
7.21754177261255236e-01,1.05496742415750089e+00,1.27027306494426652e-02,1.54643208733244893e-02,1.56262836930249581e-02,1.06736414564673066e+00,8.21258485931800064e-03,1.05990828911687058e-02,8.80613028163859668e-03,3.64945392675290248e-01,3.94903926456513121e-01,4.07137637096311900e-01,1.06892682117037474e-03,4.35601537549309362e-03,2.27727738977869729e-02,
8.92172565482469926e-01,1.05604463659245273e+00,1.83961738299286415e-02,1.93021147900629755e-02,1.99097181942944623e-02,1.06820699287566767e+00,4.86937480497405539e-03,1.60695991822748380e-02,9.37182248220805487e-03,6.01477883093844284e-02,4.23673020151696778e-01,4.53625023710171882e-01,3.28512677305698331e-01,6.22725083451572143e-03,3.33750990688754592e-02,
1.04618271215598413e+00,1.05602964514413800e+00,1.84835553822830304e-02,1.85684524250482978e-02,1.78905297390158161e-02,1.06819087028047632e+00,2.01462493715498653e-02,1.12979635034962146e-02,1.24012594043403715e-02,4.13701106791741435e-01,1.21517179836311912e-01,4.87229621111205990e-01,2.05591340915751465e-03,3.81824387727798364e-01,4.78586612461054245e-02,
1.16640445437325257e+00,1.05560586703341230e+00,1.59272139677672994e-02,1.93883728204246111e-02,2.06857034504006228e-02,1.16992442218546966e+00,1.94807116854688669e-02,1.41940059498742617e-02,1.27111504300072842e-02,6.17759794269703080e-02,1.21175710844249232e-01,5.03219854111467080e-01,4.23203795641678759e-01,4.33140974371970355e-01,6.93438342097480176e-02,
1.20345376914254243e+00,1.05581599163307338e+00,1.75760222417048959e-02,1.63733448506568763e-02,2.12059548181186761e-02,1.20569869082286196e+00,1.87823789099706637e-02,1.37902479458875352e-02,1.08511918142025661e-02,4.62987595630174997e-01,4.62502175854944020e-01,1.90662793674927500e-01,3.10040181782951724e-03,1.34598701088956552e-02,4.59388282912675527e-01,
1.25935515927522301e+00,1.05537796039970888e+00,1.62949233715404158e-02,1.64885818117863972e-02,2.01969269649419567e-02,1.25976197001826451e+00,9.34330194161745453e-02,1.33021776397916226e-02,4.05277013394480662e-02,6.19692071924162549e-02,5.05501979400708734e-01,1.90960203837364784e-01,5.15374369467340054e-01,1.93977980380816983e-02,5.07849789888873082e-01,
1.28265425818183121e+00,1.05449195098388704e+00,1.88262113257218824e-02,1.96947831208007310e-02,2.05226259779967626e-02,1.28221134217082855e+00,5.02187622106520029e-02,6.39567649628567797e-02,4.08559735729843443e-02,4.79608483203032288e-01,1.22961207718659954e-01,1.89955380592445211e-01,6.09303426684169348e-03,5.54729165035851679e-01,5.25011646817261979e-01,
1.29145330741109743e+00,1.05275475686498798e+00,1.81201516622142567e-02,1.83449088031897578e-02,2.10649451151466195e-02,1.29071077980067250e+00,3.62343851904533309e+00,1.25211011710288034e+00,5.60699469888827240e-01,6.25040654561783426e-02,1.23534273346390028e-01,1.92171185263473016e-01,5.58138596973422829e-01,6.09127587142604621e-01,5.92104214720008404e-01,

