1
1
15
0
(8 0
((0,0,0) (7,7,7) (0,0,0))
((8,0,0) (15,7,7) (0,0,0))
((0,8,0) (7,15,7) (0,0,0))
((8,8,0) (15,15,7) (0,0,0))
((0,0,8) (7,7,15) (0,0,0))
((8,0,8) (15,7,15) (0,0,0))
((0,8,8) (7,15,15) (0,0,0))
((8,8,8) (15,15,15) (0,0,0))
)
8
FabOnDisk: Cell_D_00000 0
FabOnDisk: Cell_D_00000 61527
FabOnDisk: Cell_D_00000 123055
FabOnDisk: Cell_D_00000 184583
FabOnDisk: Cell_D_00000 246112
FabOnDisk: Cell_D_00000 307640
FabOnDisk: Cell_D_00000 369169
FabOnDisk: Cell_D_00000 430698

8,15
1.2395958140686060e-02,8.1393084321425863e-02,-1.5342292331652541e-02,-1.3790472109284477e-02,-1.2779568876031877e-02,6.3108192664004381e-01,-2.8812878868134193e-03,-2.1681198427514928e-03,-6.1721326587643093e-04,-9.3646017638539889e-03,-3.8421934498712187e-02,-1.4540298361436393e-01,-3.2639628690446898e-01,-3.6312428437074107e-01,-4.4893984701655931e-01,
1.2152606374078582e-02,3.6714145500227238e-02,-9.9540190837830167e-03,-1.4514062462512202e-02,-1.2190641847049143e-02,6.3129986956974504e-01,-6.4131123485048130e-03,-1.9141107950720118e-03,-7.6205942523907371e-04,-3.5335893152870912e-01,-5.1720036393176107e-02,-1.8745085408140616e-01,-9.5360828419957591e-02,-4.2993102186728083e-01,-4.7589776622816726e-01,
1.2160745421890223e-02,1.2559696028625124e-02,-1.3256872397678464e-02,-1.0667987158180330e-02,-1.1490163537333628e-02,6.2984376061809144e-01,-3.0290104441854822e-03,-9.5623278573649956e-03,-1.3910803513230640e-02,-1.7099506368239349e-02,-3.8980923020033509e-01,-2.3786436509913128e-01,-4.1530109369554197e-01,-1.9277822552732019e-01,-5.5462834483300361e-01,
1.2193410044922448e-02,3.8356145335315668e-03,-1.6489713729576128e-02,-1.5498263403976677e-02,-1.3133653260837427e-02,6.2787575097163828e-01,-1.8732994886693697e-02,-1.4220290746407434e-02,-5.2312785790733438e-02,-4.2042880286569251e-01,-4.0015629029034977e-01,-2.9629564341549652e-01,-9.5005517487340610e-02,-1.9159268117483341e-01,-6.0964862621463078e-01,
1.2181836125079554e-02,2.3181320752479161e-03,-1.3368026421200642e-02,-1.4664463849655082e-02,-1.3508446472661096e-02,6.2874028432111273e-01,-2.9087683896113856e-03,-3.0992968502016160e-02,-4.9757460735286316e-03,-2.5311478552463830e-02,-1.0168046128925604e-01,-4.3064370801413265e-01,-5.0751792561145104e-01,-5.2127703308900053e-01,-2.9701607333336655e-01,
1.2215013555315235e-02,4.5363929423015937e-04,-1.4440972907024625e-02,-1.3309630411967423e-02,-1.2554821837208451e-02,6.2888279540743619e-01,-7.4471847121051926e-02,-1.1019897071454469e-01,-1.7810463499955839e-02,-4.5743340872782917e-01,-1.3370181579826851e-01,-4.3721403336209308e-01,-9.5984755398976440e-02,-5.9304476879486312e-01,-3.0491442429861043e-01,
1.2319119638377602e-02,-4.5074148346597651e-04,-1.5214694140501056e-02,-1.2324601490944971e-02,-1.1690716410205818e-02,6.2984980950443559e-01,-3.7283354937830526e-02,-2.3819295187917464e-02,-2.4572990488164009e-02,-4.5050834820083166e-02,-4.8609793354195091e-01,-4.6225945888922837e-01,-5.8502287390476027e-01,-1.9521073062999397e-01,-3.0486849057158222e-01,
1.2434134554406295e-02,-8.4233059712600128e-04,-1.7091208372393873e-02,-1.2609670814589798e-02,-1.4717206780723368e-02,6.2901299247612008e-01,-9.2515003504097720e-02,-9.2428950036524837e-01,-1.9395971525890614e+00,-4.8122808689520913e-01,-5.0204557719698761e-01,-5.0616716606114709e-01,-9.7735506535312822e-02,-1.9791454456574559e-01,-3.0622103644243037e-01,

8,15
7.0345844824134440e-01,1.0549677009753564e+00,1.2688721087141398e-02,1.5603745913763022e-02,1.5820497113499650e-02,1.0673636591160425e+00,7.7258522374416567e-03,1.0092728421771498e-02,8.5876112851556857e-03,3.6284811967577812e-01,3.9173832005661918e-01,4.0308494244795245e-01,1.0387084001182083e-03,4.4243138710124185e-03,2.3779316095819823e-02,
8.7402711736960237e-01,1.0560438680560127e+00,1.8325168666111280e-02,1.9434471652003925e-02,1.9847968126495759e-02,1.0682151320031730e+00,4.9036721732651639e-03,1.5808967779762623e-02,9.2473538075060740e-03,5.9785769712060996e-02,4.2250344525411243e-01,4.4969769830703410e-01,3.2323834990711281e-01,6.3221464395300147e-03,3.4860551257343629e-02,
1.0355587504717603e+00,1.0560282603708857e+00,1.8466414672484829e-02,1.8280192558877410e-02,1.7870556203442994e-02,1.0681890902216575e+00,2.0765401047961304e-02,1.1544896079702945e-02,1.2117947903764047e-02,4.1045277025494664e-01,1.2365706837712938e-01,4.8675172332364958e-01,2.0116523717554386e-03,3.7789139469793309e-01,5.0579619851059909e-02,
1.1589045526847106e+00,1.0556016198407470e+00,1.5835209081876262e-02,1.9046714572039290e-02,2.0634710306676643e-02,1.1627401672182422e+00,1.9227187109701706e-02,1.5339146635646886e-02,1.2587181428643228e-02,6.1778168738614532e-02,1.2356501473382010e-01,5.0535429995713321e-01,4.1766345676177818e-01,4.2917489334406744e-01,7.3253375247135918e-02,
1.2008740858516060e+00,1.0558251521923516e+00,1.7556610861796204e-02,1.6416108597006228e-02,2.1370999355104194e-02,1.2031922179268539e+00,1.8364931236543251e-02,1.3752476478483745e-02,1.0623740258591228e-02,4.6217015435828002e-01,4.6016911169523900e-01,1.9351787928214606e-01,3.0711522862839728e-03,1.4016751047365531e-02,4.5773993036582117e-01,
1.2581419722469003e+00,1.0553865696886506e+00,1.6208168414496401e-02,1.6739306895536019e-02,2.0394238073517982e-02,1.2585956115411305e+00,8.2334720968329028e-02,1.3676713171387344e-02,3.5780911412009370e-02,6.1975145933314144e-02,5.0439890365219242e-01,1.9406934290924782e-01,5.1370268400988062e-01,2.0211501341978459e-02,5.0477546438632748e-01,
1.2826550984706571e+00,1.0544634376862174e+00,1.8854711104905015e-02,1.9393266585421894e-02,2.0710724215921059e-02,1.2822043569871910e+00,5.2923285634269679e-02,9.7450356358282100e-02,4.4217803846185483e-02,4.7954974504781106e-01,1.2504237117210384e-01,1.9296426763583299e-01,6.0943837361086524e-03,5.5643978204222133e-01,5.2007870070922035e-01,
1.2913362914409507e+00,1.0526888812905273e+00,1.8122570881863295e-02,1.7964503176941010e-02,2.1217109642996362e-02,1.2906019868484140e+00,8.5923907012740164e-01,3.7780118214515657e-01,1.7645639449213835e-01,6.2604276880829521e-02,1.2554114317325038e-01,1.9522071772573349e-01,5.5823544004421943e-01,6.0847060674312781e-01,5.9567411204296161e-01,

