1
1
15
0
(8 0
((0,0,0) (7,7,7) (0,0,0))
((8,0,0) (15,7,7) (0,0,0))
((0,8,0) (7,15,7) (0,0,0))
((8,8,0) (15,15,7) (0,0,0))
((0,0,8) (7,7,15) (0,0,0))
((8,0,8) (15,7,15) (0,0,0))
((0,8,8) (7,15,15) (0,0,0))
((8,8,8) (15,15,15) (0,0,0))
)
8
FabOnDisk: Cell_D_00000 0
FabOnDisk: Cell_D_00000 61527
FabOnDisk: Cell_D_00000 123055
FabOnDisk: Cell_D_00000 184583
FabOnDisk: Cell_D_00000 246112
FabOnDisk: Cell_D_00000 307640
FabOnDisk: Cell_D_00000 369169
FabOnDisk: Cell_D_00000 430698

8,15
1.19011414749246314e-02,5.19220094855870132e-03,-1.38881868170529586e-02,-8.58398102191899014e-03,-7.95914255192311376e-03,6.27078050367924300e-01,-1.82480383509214263e-03,-1.24757780491955711e-02,-2.14569149141587770e-02,-1.00055315086454329e-02,-2.79495930516484754e-02,-6.07174594085860414e-02,-4.55897166267138332e-01,-4.59661622246494705e-01,-4.99363890545747868e-01,
1.17075526751710280e-02,2.27493939381384755e-03,-8.36913789932337837e-03,-1.04582406196144992e-02,-6.14793615193231884e-03,6.31867026670203114e-01,-1.92374767273787925e-02,-1.60119806008403170e-02,-2.47850619843595701e-02,-4.21089250381883384e-01,-3.44251451282735835e-02,-7.41255856999271934e-02,-5.07512560591761863e-02,-5.12312292828104865e-01,-5.14718278830135101e-01,
1.18049964926607992e-02,1.35565468779118336e-03,-1.24157169149126580e-02,-3.58466514595648985e-03,-5.63958014370897695e-03,6.29053414337161554e-01,-1.77995563785130558e-03,-6.32254791365136765e-03,-1.82647513933912459e-02,-1.43333542887916221e-02,-4.44114978833529239e-01,-8.53157802641325846e-02,-5.19009505150684447e-01,-1.11670798351177547e-01,-5.54035882200649255e-01,
1.17583393310754965e-02,2.14343038612588147e-04,-1.20890154770171999e-02,-7.51777058780672778e-03,-7.46559972021861116e-03,6.28003217122207191e-01,-8.10785100183294416e-02,-7.38599588293678277e-02,-3.22014506013472146e-01,-4.64935967611859458e-01,-4.50041833342875508e-01,-1.03533198356527814e-01,-5.32892291553149766e-02,-1.15073131787316998e-01,-6.05767166281632852e-01,
1.18590246710739526e-02,3.94547233956917237e-04,-1.33188076794351108e-02,-7.37800354433683706e-03,-1.70918156299004059e-03,6.28409746377803224e-01,-1.44281497794836074e-02,-3.42731983026812390e-02,-3.18118000484055290e-03,-1.68639688238547865e-02,-4.70688214147033240e-02,-4.42166404836647209e-01,-5.37325508995987966e-01,-5.77071198111212103e-01,-1.74884609123314744e-01,
1.18115515274532963e-02,-3.12282329188033538e-04,-1.14796267844847720e-02,-1.27480203802443903e-02,-2.23582556476399456e-03,6.29990854310663151e-01,-5.81626965601852591e-02,-2.36169653105059496e-01,-2.16513834805107108e-03,-4.78522402091693944e-01,-5.75500869131480158e-02,-4.74068121321550517e-01,-5.39395206434952548e-02,-5.97261367380468755e-01,-1.72099614039362470e-01,
1.19390608222651844e-02,-3.90617468101117009e-04,-1.13787779374805338e-02,-8.41789379198749042e-03,-1.81174000664336820e-03,6.27286759506702318e-01,-2.58142087095677500e-02,-1.14086569736064937e-02,-1.76743066482981590e-02,-2.39416841933057234e-02,-4.60020045308119407e-01,-4.93035738980626359e-01,-5.75605662024338827e-01,-1.16031289734443571e-01,-1.77968099418370607e-01,
1.18942167341111998e-02,-8.31349977840754439e-04,-1.50465021096081192e-02,-1.38348949262806498e-02,-4.36507175702534334e-03,6.25379930585689969e-01,-2.29394333635557987e-02,-1.64970012285541798e-02,-2.15844511846583764e-02,-4.84068602627324540e-01,-4.94860612757122009e-01,-5.11615870505355064e-01,-5.77857434667339437e-02,-1.19113481488847289e-01,-1.79766476899405725e-01,

8,15
1.13474851261567533e+00,1.05677377681297524e+00,1.71223152428316913e-02,2.21765327569195675e-02,2.66368526344515424e-02,1.13994071356423410e+00,1.35702086633617720e-02,1.40970599564793700e-02,1.74179738395648272e-02,4.36357363452132330e-01,4.43273201405928963e-01,4.34553365012215975e-01,1.14182899793693394e-03,3.24151511239255960e-03,7.32116908518978295e-03,
1.20178130803722572e+00,1.05756835329121546e+00,2.15356175268107547e-02,2.21949438416514551e-02,2.63210779167074999e-02,1.20405624743103967e+00,2.03076802769417038e-02,1.95288476050128057e-02,1.81375822294617961e-02,3.21197288520586113e-02,4.68095132029990868e-01,4.69624887643787459e-01,4.30412366100196453e-01,4.19152888880445530e-03,9.45030503126948959e-03,
1.23386992705891929e+00,1.05715417481163421e+00,1.96543980267834678e-02,2.50466411028396549e-02,2.61012035248259153e-02,1.23522558174671038e+00,4.14158590658944836e-02,2.34151727229999912e-02,1.77143510793213582e-02,4.51568140308618027e-01,7.29809105072691811e-02,4.89125669322918510e-01,1.75295808492092185e-03,4.84646204285363646e-01,1.11892715797801030e-02,
1.26367354322141034e+00,1.05695310961081090e+00,2.07287480318633852e-02,2.52921603322059999e-02,2.59645676018097696e-02,1.26388788626002291e+00,1.78894201566841771e-01,9.95440838396577377e-02,2.26393370529231752e-02,3.56640907501948184e-02,7.48872856786924335e-02,5.13010793460969783e-01,5.13307030409784315e-01,5.19021956493578518e-01,1.43648350427153324e-02,
1.26176358354191054e+00,1.05655461216300672e+00,1.86199580747044152e-02,2.27634774868815046e-02,3.23839616801418068e-02,1.26215813077586736e+00,5.93339623800601748e-02,4.03236255999044335e-02,3.96020932815323995e-02,4.51825507540101479e-01,4.88579461499719481e-01,1.13338832676890225e-01,2.10804668086384981e-03,6.00315624611592186e-03,4.90170171917089337e-01,
1.27735102790197885e+00,1.05638633206048671e+00,2.15943973670894712e-02,2.55076636654523320e-02,3.27440640076463105e-02,1.27703874557279073e+00,2.41366701359648383e-01,2.76969383950906450e-02,2.80697642106602196e-01,3.53902980125611749e-02,4.90474223881984639e-01,1.12888319040354138e-01,5.52413970316026015e-01,7.72772870808084798e-03,5.26478222438907295e-01,
1.28331991007559765e+00,1.05561574876251951e+00,2.25535465920190629e-02,2.57644434329081032e-02,3.16320699146832932e-02,1.28292929260749644e+00,7.15400233947676434e-02,2.38663432610044968e-01,4.80589841984161326e-01,4.93358507665531409e-01,7.49593181504006056e-02,1.14396551489507961e-01,3.24462506626664159e-03,5.39648825975675095e-01,5.65964509993794107e-01,
1.28915632093517041e+00,1.05496837638226526e+00,2.03932698243093902e-02,2.51095003266005937e-02,3.25578988904587710e-02,1.28832497095732967e+00,3.98361132792308115e-01,4.44976027087821635e-01,5.41246443345294370e-01,3.79037584017274248e-02,7.77966451545099441e-02,1.15503930392176504e-01,5.91986715188797086e-01,5.77430979688045465e-01,6.10802540166437535e-01,

