1
1
15
0
(8 0
((0,0,0) (7,7,7) (0,0,0))
((8,0,0) (15,7,7) (0,0,0))
((0,8,0) (7,15,7) (0,0,0))
((8,8,0) (15,15,7) (0,0,0))
((0,0,8) (7,7,15) (0,0,0))
((8,0,8) (15,7,15) (0,0,0))
((0,8,8) (7,15,15) (0,0,0))
((8,8,8) (15,15,15) (0,0,0))
)
8
FabOnDisk: Cell_D_00000 0
FabOnDisk: Cell_D_00000 61527
FabOnDisk: Cell_D_00000 123055
FabOnDisk: Cell_D_00000 184583
FabOnDisk: Cell_D_00000 246112
FabOnDisk: Cell_D_00000 307640
FabOnDisk: Cell_D_00000 369169
FabOnDisk: Cell_D_00000 430698

8,15
1.23420903107484686e-02,3.74182670095261002e-02,-1.43900937403541249e-02,-1.54059732178139525e-02,-1.04924842305481551e-02,6.28297415946142301e-01,-2.11697950821609221e-03,-1.18761077004326523e-03,-3.80176725523176666e-04,-9.76154081550974564e-03,-3.74152071090563948e-02,-1.11667313007567742e-01,-3.67372738112510810e-01,-4.18145458591751229e-01,-4.58104559059824112e-01,
1.21264533216200766e-02,1.57727844792430322e-02,-1.01241591262444808e-02,-1.52617088684244336e-02,-1.03039244004208240e-02,6.28543531997504679e-01,-9.36102571318341188e-03,-7.86760777679580193e-04,-1.09127959621786426e-03,-3.66645718978526935e-01,-4.83845135698699053e-02,-1.40835661498359938e-01,-7.88251808035751039e-02,-4.64253422404261429e-01,-5.18548761291529048e-01,
1.21309992180288866e-02,5.19282110556956202e-03,-1.37335309871966221e-02,-9.49887651657731549e-03,-9.18732436566551888e-03,6.28100836033764542e-01,-1.83810170696158126e-03,-9.44854769565847338e-03,-3.80919765086373541e-02,-1.67527722317055150e-02,-4.08421780680252922e-01,-1.78710106569544003e-01,-4.56967517541863544e-01,-1.71238226784133030e-01,-5.67271240073373040e-01,
1.21594050752915697e-02,1.97207250913147792e-03,-1.41830992070560886e-02,-1.24316649748243083e-02,-1.22205130834476955e-02,6.28039574141146861e-01,-1.88299428635458968e-02,-9.25651156209632633e-03,-4.63312192250018295e-02,-4.39197861381644072e-01,-4.14372793644214199e-01,-2.20740403339445113e-01,-8.23971053258980568e-02,-1.71936939156955321e-01,-5.85414314149164783e-01,
1.21894570240295482e-02,1.70111095053155671e-03,-1.35403471525408839e-02,-1.46823697441541036e-02,-9.33917515200907017e-03,6.28456242819015798e-01,-2.84310377045128094e-03,-2.37822501713286227e-02,-7.76189580891185546e-03,-2.19294384105531148e-02,-8.29929460019120657e-02,-4.44475806185114397e-01,-5.21667857039592731e-01,-5.34424704311974308e-01,-2.61079066468852095e-01,
1.22144312976900024e-02,2.79396388052457741e-04,-1.40920471211034189e-02,-1.40851017480423685e-02,-1.01738156898239160e-02,6.28470564910153295e-01,-8.30873945896671573e-02,-1.96172376041023361e-01,-2.29908605997694721e-02,-4.63435564869661809e-01,-1.05773273276539459e-01,-4.62449285867206572e-01,-8.18996786239526570e-02,-5.99595291557715182e-01,-2.61976555363268360e-01,
1.23029764755253814e-02,-4.16564826573183724e-04,-1.32036333843848948e-02,-9.68322644576222885e-03,-9.41939567999419344e-03,6.28576416232554891e-01,-3.94954777826768411e-02,-1.96093474908839854e-02,-1.78414870504996007e-02,-3.67461778841622483e-02,-4.83579733433440684e-01,-4.65933946439949009e-01,-5.70719463820799966e-01,-1.74894467365380946e-01,-2.62098541067110169e-01,
1.23787829676500153e-02,-7.47198772419470423e-04,-1.56502239567955399e-02,-1.24957990442695517e-02,-1.20182183074216721e-02,6.28100879105732757e-01,-7.26242715483871870e-02,-2.05886544354743628e-02,-3.15968620795124416e-02,-4.69594627364355532e-01,-5.07516705535356771e-01,-4.74424126197480922e-01,-8.44851831302808887e-02,-1.76109746374198434e-01,-2.63311678274811445e-01,

8,15
8.68562521075996852e-01,1.05521131874267926e+00,1.39758316212794248e-02,1.59091030626897778e-02,1.87664229456493345e-02,1.06755627035359346e+00,1.16088838469265449e-02,1.22950144467639383e-02,9.37270058430282257e-03,3.67557739381720983e-01,4.13434515350762033e-01,4.41813605032468415e-01,1.08362495338360063e-03,4.28791447900596801e-03,1.57751869370220191e-02,
1.00703336875309279e+00,1.05615153389752026e+00,1.80965912910146520e-02,1.83167454847209740e-02,2.14442767792754028e-02,1.06828567604372249e+00,5.90794138187815746e-03,1.26201168574974123e-02,1.03088391535059651e-02,5.22014139865428634e-02,4.24300674453775173e-01,4.67909253613588982e-01,3.66275418319526813e-01,5.85470008409535742e-03,2.18972420252912560e-02,
1.13231005314679178e+00,1.05610058790553185e+00,1.77410767075924097e-02,2.19116779405734985e-02,1.96918792358321756e-02,1.13750287425236141e+00,1.56070614201088316e-02,8.90736807239640542e-03,1.36734381185768215e-02,4.39952162048560580e-01,1.09310825784644045e-01,4.80426154570725905e-01,1.99422484566521988e-03,4.18512131738566495e-01,3.08054079668374815e-02,
1.21208622551612977e+00,1.05575087532376077e+00,1.76596382391727702e-02,2.20810129054366776e-02,2.22866138753263880e-02,1.21405829802526122e+00,2.45462842200511525e-02,9.95766278473008554e-03,1.47931973377584333e-02,5.30460715515935349e-02,1.10528404538848130e-01,4.80364191440240118e-01,4.56681485837065249e-01,4.60072883516427222e-01,4.24821079105068555e-02,
1.22189526213856214e+00,1.05573414959833611e+00,1.77340400593966399e-02,1.65999224924785783e-02,2.17361838601461202e-02,1.22359637308909375e+00,2.12378463442519025e-02,1.35054004110908114e-02,1.77386942769799799e-02,4.64021708542037836e-01,4.76877771587161992e-01,1.65844306051832313e-01,2.66485115558322662e-03,1.09483850664221661e-02,4.69824207190007892e-01,
1.26351248930127213e+00,1.05535394248308867e+00,1.76151686945021056e-02,1.85925775822501083e-02,2.16531712662108196e-02,1.26379188568932466e+00,1.26027100375456169e-01,1.47869726852164346e-02,7.74989286602204841e-02,5.31096266401311495e-02,5.07277699039094698e-01,1.66287835172842291e-01,5.21968747140967748e-01,1.49732498901427175e-02,5.22892126759663678e-01,
1.28260787778479468e+00,1.05450163350024839e+00,1.88055889794859453e-02,2.20436898497376015e-02,2.21710184888377973e-02,1.28219131295822142e+00,5.68539964475478499e-02,4.13830057240008806e-02,1.76653022838043960e-01,4.70882793490598361e-01,1.11526482690757600e-01,1.67685773205010602e-01,4.95131065982741363e-03,5.47924639948924264e-01,5.58874328000599885e-01,
1.29086817912639451e+00,1.05324531232859542e+00,1.74817069550969317e-02,2.14974655528302472e-02,2.21305581744161983e-02,1.29018050156790220e+00,1.33077634437440251e+00,3.23815344148032214e+00,4.78953520079369088e-01,5.41622301806943263e-02,1.12498452053182277e-01,1.68260418378217036e-01,5.69475479879389290e-01,6.05450867286469019e-01,5.63702847315073696e-01,

