1
1
15
0
(8 0
((0,0,0) (7,7,7) (0,0,0))
((8,0,0) (15,7,7) (0,0,0))
((0,8,0) (7,15,7) (0,0,0))
((8,8,0) (15,15,7) (0,0,0))
((0,0,8) (7,7,15) (0,0,0))
((8,0,8) (15,7,15) (0,0,0))
((0,8,8) (7,15,15) (0,0,0))
((8,8,8) (15,15,15) (0,0,0))
)
8
FabOnDisk: Cell_D_00000 0
FabOnDisk: Cell_D_00000 61527
FabOnDisk: Cell_D_00000 123055
FabOnDisk: Cell_D_00000 184583
FabOnDisk: Cell_D_00000 246112
FabOnDisk: Cell_D_00000 307640
FabOnDisk: Cell_D_00000 369169
FabOnDisk: Cell_D_00000 430698

8,15
1.21683894570357130e-02,1.14774048230236285e-02,-1.46133781583626578e-02,-1.11975814711279854e-02,-6.78864367679818913e-03,6.30343375808767759e-01,-2.09731069022670458e-03,5.37079132334511607e-04,-4.86064008489793704e-03,-1.01548026286599931e-02,-2.96169093679829812e-02,-8.13213345839273183e-02,-4.08714408048082456e-01,-4.46256538433886629e-01,-5.06237880459098566e-01,
1.19703595651606681e-02,4.58966379642790790e-03,-8.78237629881763356e-03,-1.15174197753981390e-02,-5.31999735897035163e-03,6.28632218749995197e-01,-8.79864893249851510e-03,-1.17054435346121422e-02,-2.71101102090259768e-02,-3.99831588218705791e-01,-3.72157940948231181e-02,-1.00600287618267392e-01,-6.35591345493812243e-02,-4.64204419556199233e-01,-5.34591225933943148e-01,
1.20201661062478097e-02,2.33551941198033861e-03,-1.35962434528395359e-02,-5.90401974875537534e-03,-5.68795813431570776e-03,6.28933159051542900e-01,-1.75132463625516949e-03,-3.09486433558372499e-03,-3.30957894959788140e-02,-1.54580539716284333e-02,-4.31262182993744914e-01,-1.20409844846100247e-01,-5.00492607216084684e-01,-1.32494558240559113e-01,-5.41350463227378675e-01,
1.20161521282300399e-02,8.28781449064595302e-04,-1.25177581357197674e-02,-7.25482792522508940e-03,-6.77941952488770021e-03,6.28671174461171267e-01,-4.28251348593466988e-02,-9.23937219313372519e-03,-3.14203046962810290e-02,-4.54591187170919675e-01,-4.39269424922262453e-01,-1.47339575632247699e-01,-6.52424597823406394e-02,-1.34100392588202222e-01,-5.77105316977700955e-01,
1.20733380535139531e-02,7.28519552161485976e-04,-1.15948099114061235e-02,-9.15060820081832656e-03,-3.75679365774326916e-03,6.29417674011417017e-01,-1.22407309082209967e-02,-2.47236695150624616e-02,-3.98862741999037474e-03,-1.93089051074655030e-02,-5.65104036127608289e-02,-4.51838031730571077e-01,-5.39343848953171667e-01,-5.70809928097055330e-01,-2.11103395601094590e-01,
1.20972790623522456e-02,-4.60354945381519871e-04,-1.32049284696743024e-02,-1.19180961653355191e-02,-4.54584021125308945e-03,6.27470813431064145e-01,-2.11064464299194690e-02,-6.67868402990026422e-02,-5.50571449756857758e-03,-4.73492550656027911e-01,-7.02796129171733008e-02,-4.78267706014629035e-01,-6.38041283228589357e-02,-6.07023949403827312e-01,-2.14098533063696000e-01,
1.21538768550026877e-02,-4.15151919716760592e-04,-1.21131900131175932e-02,-1.01308220517036373e-02,-4.88210432365278162e-03,6.29088191296550248e-01,-2.68214705701113540e-02,-1.84573991645910873e-01,-2.41675511711886525e-02,-2.89522098279223102e-02,-4.69223692153149241e-01,-4.92733500115449252e-01,-5.61118384611364096e-01,-1.36762668029358880e-01,-2.18391252155271887e-01,
1.22037542682032346e-02,-8.12448084083331888e-04,-1.73478044086535534e-02,-1.46755304139274262e-02,-6.76907415721003138e-03,6.28042593464066323e-01,-4.33717947244396385e-02,-1.67422785514333705e-02,-2.27248254200454261e-02,-4.78164502262552304e-01,-5.02588764205971872e-01,-4.97879418429675591e-01,-6.96483653013119514e-02,-1.38163141831281200e-01,-2.18855465228477541e-01,

8,15
1.04651388678460489e+00,1.05589845762643031e+00,1.64597043345645205e-02,2.03818156334744718e-02,2.54770098185017752e-02,1.06809238244580285e+00,1.25352312661506319e-02,1.23208977452233109e-02,1.52252565245013741e-02,4.16008998601346325e-01,4.08217951828548919e-01,4.52132211065826184e-01,1.13944037913289243e-03,3.38586621645315050e-03,1.02378136205475076e-02,
1.14390350552395348e+00,1.05672133978468774e+00,2.13131113744823783e-02,2.21599784882296237e-02,2.53483644683123593e-02,1.14849316932038148e+00,1.09948113179097178e-02,1.48879164723594200e-02,1.88180140404613609e-02,4.05817326575932669e-02,4.44809680953054676e-01,4.52370356895156089e-01,4.09754861644633428e-01,4.47524351460640377e-03,1.35820606101355081e-02,
1.20141380448028889e+00,1.05642086227194643e+00,1.91263579120780694e-02,2.50130014398745118e-02,2.51291055775469847e-02,1.20374932389226919e+00,1.85199954866546238e-02,1.01527002732697963e-02,1.55724951077858310e-02,4.53421023607068152e-01,8.51000683360786520e-02,4.58242917659524240e-01,1.86736411138360486e-03,4.57096471938230720e-01,1.71438317762299883e-02,
1.24900336446163007e+00,1.05608752850226484e+00,2.05920801266183742e-02,2.60385947203706086e-02,2.66801736141464019e-02,1.24983214591069469e+00,5.91747710407228983e-02,2.77075711104313241e-02,2.06427067948215387e-02,4.29968249314858567e-02,8.59172562485567282e-02,4.96969838295747146e-01,4.90202986762188098e-01,4.96713442482326406e-01,2.25996387889687081e-02,
1.25275398799797122e+00,1.05598132551428447e+00,1.99750369087462291e-02,2.28056060659465737e-02,2.98620454176783644e-02,1.25348250755013280e+00,1.09955192064827623e-01,3.93572627479887027e-02,4.99076914162722152e-02,4.59045549649979068e-01,4.92163963210654365e-01,1.37428382000110788e-01,2.38736478383140809e-03,7.20819138695185605e-03,4.80216747049796222e-01,
1.27529480189144317e+00,1.05566909584621471e+00,1.98071853199946191e-02,2.54125250579115523e-02,2.98263747150171593e-02,1.27504488192227994e+00,3.92884759085339458e-02,2.56288476145913671e-02,4.41773905249476517e-02,4.26860137522653005e-02,5.01843276093273283e-01,1.37974497365244864e-01,5.43490216078134525e-01,9.48585206831897149e-03,5.37246274018340686e-01,
1.28500638505039744e+00,1.05498284763146932e+00,2.28710693991644107e-02,2.52482877876274159e-02,2.83743800429387266e-02,1.28459123313068058e+00,7.21111549429717391e-02,5.96870808057243171e-02,5.47772613743110620e-02,4.83778049876463556e-01,8.77698322892944693e-02,1.39568076217563369e-01,3.92199453150667877e-03,5.25262508187186783e-01,5.77329882062302957e-01,
1.29099849333510819e+00,1.05417333887072395e+00,1.94842861252724694e-02,2.44419579419171105e-02,2.90751948441996672e-02,1.29018604525102476e+00,2.21943701063721632e-01,1.84719005728607805e-01,4.05270771390825235e-01,4.50012117833411690e-02,8.93152312029996953e-02,1.40037735970821309e-01,5.83752155558408203e-01,5.90210501242708685e-01,6.06523473922634615e-01,

