1
1
15
0
(8 0
((0,0,0) (7,7,7) (0,0,0))
((8,0,0) (15,7,7) (0,0,0))
((0,8,0) (7,15,7) (0,0,0))
((8,8,0) (15,15,7) (0,0,0))
((0,0,8) (7,7,15) (0,0,0))
((8,0,8) (15,7,15) (0,0,0))
((0,8,8) (7,15,15) (0,0,0))
((8,8,8) (15,15,15) (0,0,0))
)
8
FabOnDisk: Cell_D_00000 0
FabOnDisk: Cell_D_00000 61527
FabOnDisk: Cell_D_00000 123055
FabOnDisk: Cell_D_00000 184583
FabOnDisk: Cell_D_00000 246112
FabOnDisk: Cell_D_00000 307640
FabOnDisk: Cell_D_00000 369169
FabOnDisk: Cell_D_00000 430698

8,15
1.2168389457035713e-02,1.1477404823023628e-02,-1.4613378158362658e-02,-1.1197581471127985e-02,-6.7886436767981891e-03,6.3034337580876776e-01,-2.0973106902267046e-03,5.3707913233451161e-04,-4.8606400848979370e-03,-1.0154802628659993e-02,-2.9616909367982981e-02,-8.1321334583927318e-02,-4.0871440804808246e-01,-4.4625653843388663e-01,-5.0623788045909857e-01,
1.1970359565160668e-02,4.5896637964279079e-03,-8.7823762988176336e-03,-1.1517419775398139e-02,-5.3199973589703516e-03,6.2863221874999520e-01,-8.7986489324985151e-03,-1.1705443534612142e-02,-2.7110110209025977e-02,-3.9983158821870579e-01,-3.7215794094823118e-02,-1.0060028761826739e-01,-6.3559134549381224e-02,-4.6420441955619923e-01,-5.3459122593394315e-01,
1.2020166106247810e-02,2.3355194119803386e-03,-1.3596243452839536e-02,-5.9040197487553753e-03,-5.6879581343157078e-03,6.2893315905154290e-01,-1.7513246362551695e-03,-3.0948643355837250e-03,-3.3095789495978814e-02,-1.5458053971628433e-02,-4.3126218299374491e-01,-1.2040984484610025e-01,-5.0049260721608468e-01,-1.3249455824055911e-01,-5.4135046322737868e-01,
1.2016152128230040e-02,8.2878144906459530e-04,-1.2517758135719767e-02,-7.2548279252250894e-03,-6.7794195248877002e-03,6.2867117446117127e-01,-4.2825134859346699e-02,-9.2393721931337252e-03,-3.1420304696281029e-02,-4.5459118717091967e-01,-4.3926942492226245e-01,-1.4733957563224770e-01,-6.5242459782340639e-02,-1.3410039258820222e-01,-5.7710531697770096e-01,
1.2073338053513953e-02,7.2851955216148598e-04,-1.1594809911406124e-02,-9.1506082008183266e-03,-3.7567936577432692e-03,6.2941767401141702e-01,-1.2240730908220997e-02,-2.4723669515062462e-02,-3.9886274199903747e-03,-1.9308905107465503e-02,-5.6510403612760829e-02,-4.5183803173057108e-01,-5.3934384895317167e-01,-5.7080992809705533e-01,-2.1110339560109459e-01,
1.2097279062352246e-02,-4.6035494538151987e-04,-1.3204928469674302e-02,-1.1918096165335519e-02,-4.5458402112530895e-03,6.2747081343106414e-01,-2.1106446429919469e-02,-6.6786840299002642e-02,-5.5057144975685776e-03,-4.7349255065602791e-01,-7.0279612917173301e-02,-4.7826770601462903e-01,-6.3804128322858936e-02,-6.0702394940382731e-01,-2.1409853306369600e-01,
1.2153876855002688e-02,-4.1515191971676059e-04,-1.2113190013117593e-02,-1.0130822051703637e-02,-4.8821043236527816e-03,6.2908819129655025e-01,-2.6821470570111354e-02,-1.8457399164591087e-01,-2.4167551171188652e-02,-2.8952209827922310e-02,-4.6922369215314924e-01,-4.9273350011544925e-01,-5.6111838461136410e-01,-1.3676266802935888e-01,-2.1839125215527189e-01,
1.2203754268203235e-02,-8.1244808408333189e-04,-1.7347804408653553e-02,-1.4675530413927426e-02,-6.7690741572100314e-03,6.2804259346406632e-01,-4.3371794724439638e-02,-1.6742278551433371e-02,-2.2724825420045426e-02,-4.7816450226255230e-01,-5.0258876420597187e-01,-4.9787941842967559e-01,-6.9648365301311951e-02,-1.3816314183128120e-01,-2.1885546522847754e-01,

8,15
1.0465138867846049e+00,1.0558984576264303e+00,1.6459704334564521e-02,2.0381815633474472e-02,2.5477009818501775e-02,1.0680923824458028e+00,1.2535231266150632e-02,1.2320897745223311e-02,1.5225256524501374e-02,4.1600899860134632e-01,4.0821795182854892e-01,4.5213221106582618e-01,1.1394403791328924e-03,3.3858662164531505e-03,1.0237813620547508e-02,
1.1439035055239535e+00,1.0567213397846877e+00,2.1313111374482378e-02,2.2159978488229624e-02,2.5348364468312359e-02,1.1484931693203815e+00,1.0994811317909718e-02,1.4887916472359420e-02,1.8818014040461361e-02,4.0581732657593267e-02,4.4480968095305468e-01,4.5237035689515609e-01,4.0975486164463343e-01,4.4752435146064038e-03,1.3582060610135508e-02,
1.2014138044802889e+00,1.0564208622719464e+00,1.9126357912078069e-02,2.5013001439874512e-02,2.5129105577546985e-02,1.2037493238922692e+00,1.8519995486654624e-02,1.0152700273269796e-02,1.5572495107785831e-02,4.5342102360706815e-01,8.5100068336078652e-02,4.5824291765952424e-01,1.8673641113836049e-03,4.5709647193823072e-01,1.7143831776229988e-02,
1.2490033644616301e+00,1.0560875285022648e+00,2.0592080126618374e-02,2.6038594720370609e-02,2.6680173614146402e-02,1.2498321459106947e+00,5.9174771040722898e-02,2.7707571110431324e-02,2.0642706794821539e-02,4.2996824931485857e-02,8.5917256248556728e-02,4.9696983829574715e-01,4.9020298676218810e-01,4.9671344248232641e-01,2.2599638788968708e-02,
1.2527539879979712e+00,1.0559813255142845e+00,1.9975036908746229e-02,2.2805606065946574e-02,2.9862045417678364e-02,1.2534825075501328e+00,1.0995519206482762e-01,3.9357262747988703e-02,4.9907691416272215e-02,4.5904554964997907e-01,4.9216396321065436e-01,1.3742838200011079e-01,2.3873647838314081e-03,7.2081913869518561e-03,4.8021674704979622e-01,
1.2752948018914432e+00,1.0556690958462147e+00,1.9807185319994619e-02,2.5412525057911552e-02,2.9826374715017159e-02,1.2750448819222799e+00,3.9288475908533946e-02,2.5628847614591367e-02,4.4177390524947652e-02,4.2686013752265300e-02,5.0184327609327328e-01,1.3797449736524486e-01,5.4349021607813452e-01,9.4858520683189715e-03,5.3724627401834069e-01,
1.2850063850503974e+00,1.0549828476314693e+00,2.2871069399164411e-02,2.5248287787627416e-02,2.8374380042938727e-02,1.2845912331306806e+00,7.2111154942971739e-02,5.9687080805724317e-02,5.4777261374311062e-02,4.8377804987646356e-01,8.7769832289294469e-02,1.3956807621756337e-01,3.9219945315066788e-03,5.2526250818718678e-01,5.7732988206230296e-01,
1.2909984933351082e+00,1.0541733388707240e+00,1.9484286125272469e-02,2.4441957941917111e-02,2.9075194844199667e-02,1.2901860452510248e+00,2.2194370106372163e-01,1.8471900572860780e-01,4.0527077139082524e-01,4.5001211783341169e-02,8.9315231202999695e-02,1.4003773597082131e-01,5.8375215555840820e-01,5.9021050124270868e-01,6.0652347392263462e-01,

