1
1
15
0
(8 0
((0,0,0) (7,7,7) (0,0,0))
((8,0,0) (15,7,7) (0,0,0))
((0,8,0) (7,15,7) (0,0,0))
((8,8,0) (15,15,7) (0,0,0))
((0,0,8) (7,7,15) (0,0,0))
((8,0,8) (15,7,15) (0,0,0))
((0,8,8) (7,15,15) (0,0,0))
((8,8,8) (15,15,15) (0,0,0))
)
8
FabOnDisk: Cell_D_00000 0
FabOnDisk: Cell_D_00000 61527
FabOnDisk: Cell_D_00000 123055
FabOnDisk: Cell_D_00000 184583
FabOnDisk: Cell_D_00000 246112
FabOnDisk: Cell_D_00000 307640
FabOnDisk: Cell_D_00000 369169
FabOnDisk: Cell_D_00000 430698

8,15
1.21716496525915725e-02,1.07170596713986200e-02,-1.46128146020441021e-02,-1.09384519156677570e-02,-7.09754432111812765e-03,6.30586308562532727e-01,-2.02361113304119549e-03,5.61182234510416642e-04,-6.60042282052983233e-03,-1.03755177164015118e-02,-2.92482635624215850e-02,-7.88563656395621787e-02,-4.13132009968027347e-01,-4.46000015896042712e-01,-5.06905565778233536e-01,
1.19713749466331312e-02,4.27863350089366292e-03,-8.72080123713041104e-03,-1.13486261671407254e-02,-5.67005815779412364e-03,6.29345305423297585e-01,-9.28558500277462846e-03,-1.24858631465110982e-02,-2.84216717403120364e-02,-4.02784463445901575e-01,-3.67914665399752608e-02,-9.76704399895248071e-02,-6.36936961409484415e-02,-4.69267333379941309e-01,-5.33272241380236545e-01,
1.20223187847661294e-02,2.24274125585307346e-03,-1.34720635438799249e-02,-6.16551786760099682e-03,-5.92970021260262256e-03,6.29063027078492265e-01,-1.82254334329329118e-03,-3.67184754749805796e-03,-3.19647528168346129e-02,-1.57116330926885817e-02,-4.32376545474718599e-01,-1.15828362447471647e-01,-5.02634610382157399e-01,-1.30445505421581925e-01,-5.38062019144221471e-01,
1.20167037724647086e-02,7.68039932657279515e-04,-1.26196216487121926e-02,-7.38425363435798315e-03,-6.52384727530753820e-03,6.28628853712288826e-01,-4.58161481732701284e-02,-9.95052235820958336e-03,-3.76688489984496819e-02,-4.55757082838262217e-01,-4.40426041516357669e-01,-1.41994392307536160e-01,-6.55203455422007225e-02,-1.31959219155344948e-01,-5.80415154522886390e-01,
1.20778570847032626e-02,7.13140002931712076e-04,-1.14899929016527638e-02,-8.78095321405099154e-03,-3.80489012756936480e-03,6.29269042585261840e-01,-1.30490962842320889e-02,-2.65455870832280519e-02,-4.12207976874939298e-03,-1.95652271332799228e-02,-5.51369372904763413e-02,-4.51289781920747868e-01,-5.40423566702881386e-01,-5.71567876964059973e-01,-2.07475206407127022e-01,
1.21000829587557448e-02,-1.97922142849529575e-04,-1.32076031396090275e-02,-1.22322352785209330e-02,-4.53655884018313183e-03,6.27503358874970885e-01,-1.69995330659116033e-02,-4.43276383721101092e-02,-5.08138868867762279e-03,-4.73785262110905103e-01,-6.86581433840420807e-02,-4.78659985205343308e-01,-6.41454372610534701e-02,-6.06226540486347165e-01,-2.10746523152297804e-01,
1.21559386852721375e-02,-4.16760600810266136e-04,-1.21150060897385788e-02,-1.01045143947495735e-02,-5.02997063366302736e-03,6.29355089872970619e-01,-2.75153440982463596e-02,-2.70426624479503885e-01,-3.53542907144555815e-02,-2.91723929866875183e-02,-4.67654639810924255e-01,-4.93492878080921904e-01,-5.61027821680198491e-01,-1.33840499591084905e-01,-2.14844834791265149e-01,
1.22057541152233197e-02,-8.15753802231031395e-04,-1.73872936851533766e-02,-1.48135023881295989e-02,-6.78464972831619925e-03,6.28105945585316738e-01,-4.00035172262118502e-02,-1.66190767012610145e-02,-2.20841031441717170e-02,-4.78094358442757494e-01,-5.01764724481656432e-01,-5.00437752600791486e-01,-7.02593731123110493e-02,-1.35775351162135183e-01,-2.15227751403905210e-01,

8,15
1.05499668121023649e+00,1.05588762216592280e+00,1.64737521184815106e-02,2.01541412595649325e-02,2.53026706229772871e-02,1.06808573203714663e+00,1.26855685495096543e-02,1.25690516612407023e-02,1.50731705984725409e-02,4.18243666076403064e-01,4.11761488141989984e-01,4.50748969490548768e-01,1.16481345522952530e-03,3.34622682171646733e-03,9.86162282517195898e-03,
1.15039216933891342e+00,1.05671300302964966e+00,2.13221200120901795e-02,2.23875890357229448e-02,2.51795235725619862e-02,1.15467080283980716e+00,1.18789669589273311e-02,1.56125531595656779e-02,1.88385646017621283e-02,4.05804829844014434e-02,4.47551478294986982e-01,4.49584458164902334e-01,4.11323190052261423e-01,4.42847186372151425e-03,1.30861232353349788e-02,
1.20432612914147219e+00,1.05642516678108001e+00,1.92099326886761984e-02,2.49237076313758195e-02,2.49761049072919836e-02,1.20656887039732519e+00,1.91216230341761384e-02,9.95708615309058055e-03,1.54966675503276276e-02,4.54047542646926372e-01,8.36113739462370498e-02,4.61173193862805253e-01,1.89905562101474849e-03,4.59116516376637307e-01,1.62852552882723003e-02,
1.25064289467227518e+00,1.05608635857993693e+00,2.04865969141400546e-02,2.59494790193300733e-02,2.64812134056455935e-02,1.25141093460493247e+00,6.41162774255993745e-02,2.98496475553786181e-02,2.06343559021406053e-02,4.33724262800912821e-02,8.48364934840958596e-02,4.99078010202431477e-01,4.93110989525974486e-01,4.98812714671703294e-01,2.14747666228265362e-02,
1.25424122753346956e+00,1.05597823637781452e+00,1.99540577276521927e-02,2.29523998596693722e-02,2.98809578769071819e-02,1.25495436753640122e+00,5.33983722027523144e-02,3.46292960404728789e-02,3.44785210874810066e-02,4.59112701331029993e-01,4.91874013161723633e-01,1.35445073189748522e-01,2.42122440077004826e-03,7.02812511824378334e-03,4.79339531047037304e-01,
1.27646825145672560e+00,1.05566025343363989e+00,1.97355328925550855e-02,2.55916697237929640e-02,2.98383405610332941e-02,1.27627032931387596e+00,3.98338057514669025e-02,2.74137234111455248e-02,4.72670143517965879e-02,4.28858844003788542e-02,5.00342082052844139e-01,1.35996008077979097e-01,5.45016778952165049e-01,9.26043281559543394e-03,5.37324242329715318e-01,
1.28507924156966147e+00,1.05500004862253749e+00,2.30058361861737032e-02,2.51970081319072906e-02,2.85051125169358509e-02,1.28466248096885116e+00,6.84363591068798960e-02,5.26130883539080857e-02,5.21276074571135478e-02,4.83665240966349885e-01,8.58385579003395904e-02,1.37088189759510620e-01,3.95202759556620691e-03,5.24396613844204218e-01,5.76560775837741901e-01,
1.29103310052067499e+00,1.05419276867260803e+00,1.94632933682655287e-02,2.43146564722840977e-02,2.91133242134891598e-02,1.29021734671844390e+00,4.93299086441963908e-01,5.76799528632943259e-01,1.60539359529131787e+00,4.52892468556632954e-02,8.77941424174776969e-02,1.37883030358834813e-01,5.83345912505557451e-01,5.88801459674346495e-01,6.08231555340167929e-01,

