1
1
15
0
(8 0
((0,0,0) (7,7,7) (0,0,0))
((8,0,0) (15,7,7) (0,0,0))
((0,8,0) (7,15,7) (0,0,0))
((8,8,0) (15,15,7) (0,0,0))
((0,0,8) (7,7,15) (0,0,0))
((8,0,8) (15,7,15) (0,0,0))
((0,8,8) (7,15,15) (0,0,0))
((8,8,8) (15,15,15) (0,0,0))
)
8
FabOnDisk: Cell_D_00000 0
FabOnDisk: Cell_D_00000 61527
FabOnDisk: Cell_D_00000 123055
FabOnDisk: Cell_D_00000 184583
FabOnDisk: Cell_D_00000 246112
FabOnDisk: Cell_D_00000 307640
FabOnDisk: Cell_D_00000 369169
FabOnDisk: Cell_D_00000 430698

8,15
1.17224887712546449e-02,4.28106154264120721e-03,-1.35961528638795289e-02,-9.51482904414585953e-03,-8.07756554489489145e-03,6.26631959399492122e-01,-1.58753249240624339e-03,-1.34126704065573900e-02,-2.27511018688803177e-02,-1.00947612569089462e-02,-2.73247146265134244e-02,-5.69568845613453792e-02,-4.66419495792123717e-01,-4.73630873914708483e-01,-4.93147991771941352e-01,
1.15381621112364448e-02,1.91035593381866115e-03,-8.23931131558841914e-03,-1.00090464921595169e-02,-6.28232799151647731e-03,6.30130876648309135e-01,-2.42590480840668282e-02,-1.03103196282187393e-02,-1.88020700706017160e-02,-4.26766652422594206e-01,-3.34354678941321121e-02,-6.91288607267251387e-02,-4.68565623888654859e-02,-5.22152711482596787e-01,-5.28973132697316606e-01,
1.16309560279206688e-02,1.19081638417794849e-03,-1.37183211035114862e-02,-2.68642702852088088e-03,-5.35007740084582351e-03,6.28344450394192178e-01,-1.29876313777150003e-03,-6.69121594579082102e-03,-1.40496539167314707e-02,-1.41628179904590423e-02,-4.47078417207889434e-01,-7.83208827621569986e-02,-5.20812410649935331e-01,-1.04034524867813796e-01,-5.61950574640713629e-01,
1.15931986386409586e-02,8.31834412898791971e-05,-1.12901902494137747e-02,-6.47273549822240633e-03,-7.99492929268492622e-03,6.27873879364145404e-01,-9.34237555065306757e-02,-2.05799790907082780e-01,-8.98674788271078051e-01,-4.67006784828267740e-01,-4.52893616260702125e-01,-9.46317895133863829e-02,-5.03260127813438540e-02,-1.08155401913725649e-01,-6.08360958974113020e-01,
1.16695969746840079e-02,3.24628697442030435e-04,-1.41993390509515694e-02,-8.39559072258189848e-03,-8.25705721136908363e-04,6.28337251917130302e-01,-1.24879428355453275e-02,-4.51927036010834685e-02,-2.37063380023104248e-03,-1.64299167761166598e-02,-4.43813531319409149e-02,-4.39304602008522060e-01,-5.35090809818862811e-01,-5.76090712074441846e-01,-1.65269500143457232e-01,
1.16386755694655158e-02,-3.13872881569140691e-04,-1.02088149393517631e-02,-1.34414950881133026e-02,-1.50550570414640034e-03,6.29866837870037055e-01,-3.68559839885017115e-01,-1.44714177245381004e+00,-7.94961159247068068e-04,-4.79474244954440132e-01,-5.39709197309582236e-02,-4.71822293744080412e-01,-5.06689604229423399e-02,-5.91450125317311670e-01,-1.63769133971659375e-01,
1.17589065607096518e-02,-3.69053017459296912e-04,-1.23361997953165582e-02,-6.78335238730813118e-03,-1.08127542718006262e-03,6.26016770303384318e-01,-3.10270978899313508e-02,-1.44807514748762686e-02,-1.53178101635635406e-02,-2.29145383438307051e-02,-4.55841195810267830e-01,-4.90261281203538068e-01,-5.77860243279830099e-01,-1.08841215453901977e-01,-1.67551362446659191e-01,
1.17110559543382280e-02,-7.98739355745300213e-04,-1.40408572144271517e-02,-1.24643220972929653e-02,-3.43790579754595180e-03,6.25631658655446454e-01,-3.38489221534104545e-02,-4.27537624647906650e-02,-1.99961933779022397e-02,-4.85023740152039640e-01,-4.91060424727989275e-01,-5.11402912588553749e-01,-5.48231612966752838e-02,-1.12721163081170486e-01,-1.69376707545184357e-01,

8,15
1.15366662633462691e+00,1.05763683410083775e+00,1.74999718489340615e-02,2.25684702032414135e-02,2.70941128047215152e-02,1.15794768787726809e+00,1.35811581386436168e-02,1.50842987731011815e-02,1.82818761163953264e-02,4.39594702960677819e-01,4.50473423211091184e-01,4.46757812207415228e-01,1.16167119946532444e-03,3.18137599411909104e-03,6.84651805442205389e-03,
1.21276909112342768e+00,1.05841666808769452e+00,2.14457173908428438e-02,2.24257109003402760e-02,2.69162170386623226e-02,1.21467944705724640e+00,2.30597552600202739e-02,1.98544272631539162e-02,1.84510839678017277e-02,2.98799344155756159e-02,4.71513317223132944e-01,4.78277834929037804e-01,4.33883714653560237e-01,4.08400858066603964e-03,8.76106360673555538e-03,
1.23886907268460633e+00,1.05782835357893701e+00,1.94001124588020837e-02,2.60490209572779435e-02,2.67175178121681588e-02,1.24005988906878417e+00,5.18673309457459014e-02,2.50157434137961467e-02,1.86591835837300567e-02,4.49841803146483477e-01,6.85470854510941141e-02,4.93549469961123477e-01,1.74094626692417563e-03,4.90282003966442836e-01,1.01490183620917655e-02,
1.26529892113219744e+00,1.05775903824543560e+00,2.25442237637956434e-02,2.63954929006777680e-02,2.62920596150122317e-02,1.26538210457348721e+00,4.10502554608472736e-01,1.46355836912550941e-01,2.34151132379266623e-02,3.36669029211301568e-02,7.08645693608721539e-02,5.13521224749517002e-01,5.17916709391044616e-01,5.23678620288286933e-01,1.29305244690244101e-02,
1.26291336614370375e+00,1.05693256852234452e+00,1.73272619030363922e-02,2.23802859751623152e-02,3.38283773378411159e-02,1.26323799484114585e+00,5.92345710227559219e-02,4.03766326545494242e-02,4.84752369513413717e-02,4.48711980495076213e-01,4.85398969462269236e-01,1.06709770973588608e-01,2.06249790478572545e-03,5.65623903483774160e-03,4.97169251173429860e-01,
1.27680525328783001e+00,1.05717525408947144e+00,2.32256285301986713e-02,2.51809287356528876e-02,3.46371146917364078e-02,1.27649138040626098e+00,2.13442271451823734e-01,2.77843396220160965e-02,2.38385972694678649e-01,3.31189005094442712e-02,4.86330739488792352e-01,1.06438500810246583e-01,5.54322853201017374e-01,7.23192707807963908e-03,5.22936281261227154e-01,
1.28213292091321507e+00,1.05591113450176866e+00,2.17141905674688752e-02,2.77004219150158298e-02,3.37527002785455860e-02,1.28176386789575569e+00,5.86753104736220804e-02,9.58970300627201844e-02,2.07377241801994822e-01,4.95053817089969983e-01,7.05895902271453934e-02,1.08006913052912157e-01,3.10380138223052002e-03,5.44178625891618251e-01,5.59634576066187717e-01,
1.28784045060133079e+00,1.05563417279285932e+00,2.13761716153223549e-02,2.71339583246291774e-02,3.47359361916443274e-02,1.28704171124558542e+00,3.24987027030668230e-01,2.67093002510357280e-01,4.80119137239235216e-01,3.60446107297716922e-02,7.38454086325792264e-02,1.09132554883507593e-01,5.92770666429809023e-01,5.71187310913888413e-01,6.07202021050834428e-01,

