1
1
15
0
(8 0
((0,0,0) (7,7,7) (0,0,0))
((8,0,0) (15,7,7) (0,0,0))
((0,8,0) (7,15,7) (0,0,0))
((8,8,0) (15,15,7) (0,0,0))
((0,0,8) (7,7,15) (0,0,0))
((8,0,8) (15,7,15) (0,0,0))
((0,8,8) (7,15,15) (0,0,0))
((8,8,8) (15,15,15) (0,0,0))
)
8
FabOnDisk: Cell_D_00000 0
FabOnDisk: Cell_D_00000 61527
FabOnDisk: Cell_D_00000 123055
FabOnDisk: Cell_D_00000 184583
FabOnDisk: Cell_D_00000 246112
FabOnDisk: Cell_D_00000 307640
FabOnDisk: Cell_D_00000 369169
FabOnDisk: Cell_D_00000 430698

8,15
1.23510608844987491e-02,4.06380565379672876e-02,-1.46978777151889027e-02,-1.55015948709197396e-02,-1.09658619998079625e-02,6.29314564377668528e-01,-2.26876896516873270e-03,-1.40747415792904520e-03,-4.47296478051851978e-04,-9.73168893500388557e-03,-3.78261032731604940e-02,-1.14347411723129372e-01,-3.64177042420824382e-01,-4.13863729189285046e-01,-4.52547551190171649e-01,
1.21309680440930857e-02,1.73007114285065634e-02,-1.00711183718494839e-02,-1.54317773364103135e-02,-1.06838722317062988e-02,6.29188839978614300e-01,-9.17463545343957104e-03,-1.00925665827700413e-03,-1.20342040216372091e-03,-3.65617112838641456e-01,-4.91010346330064684e-02,-1.44590612401900215e-01,-8.06561358534110262e-02,-4.61985137902745147e-01,-5.15137409270393309e-01,
1.21359942687007429e-02,5.60067358268503436e-03,-1.36894410333911355e-02,-9.69101748459201030e-03,-9.56617854059181420e-03,6.28004952366284952e-01,-1.82018153986205104e-03,-9.76091893918258624e-03,-3.63783585935512771e-02,-1.68310605045917452e-02,-4.06623148708783466e-01,-1.83796371249905721e-01,-4.52344953890016055e-01,-1.73414746578762463e-01,-5.67534940824877210e-01,
1.21639226394848858e-02,2.08430963309012146e-03,-1.45585824070895795e-02,-1.29094752478505614e-02,-1.24407231634897295e-02,6.28048480331178105e-01,-1.78500774675838247e-02,-9.61657389219564875e-03,-4.66738829011823647e-02,-4.37715607219122171e-01,-4.12655330989123770e-01,-2.27347780657095822e-01,-8.36968983670423050e-02,-1.74279500468129150e-01,-5.88739452380335648e-01,
1.21890180569808396e-02,1.76042557134129841e-03,-1.37100196452567130e-02,-1.49098592415041198e-02,-9.92746473355489087e-03,6.28433758588374802e-01,-2.89400796828223963e-03,-2.42634945526684631e-02,-7.44604012483405207e-03,-2.22313768719413947e-02,-8.51822445715280929e-02,-4.43428894215149472e-01,-5.20324697362469890e-01,-5.31730256954391245e-01,-2.64824648503030113e-01,
1.22161482110927540e-02,2.97413663631647038e-04,-1.41575946617465386e-02,-1.42946213399325079e-02,-1.04025279496848221e-02,6.28679443788802805e-01,-8.44956849061960225e-02,-1.83223682422522571e-01,-2.26807276763673626e-02,-4.62831689219528442e-01,-1.08880273696263755e-01,-4.60631798662048064e-01,-8.33300767642240620e-02,-5.99091306804752532e-01,-2.66321451986780477e-01,
1.23052316054220214e-02,-4.19918049441428518e-04,-1.34139185254189709e-02,-9.92727899490123550e-03,-9.57233790403786214e-03,6.28738145201799270e-01,-6.55978166528184831e-02,-2.04721130806778742e-02,-1.83385418130118973e-02,-3.75279279216695488e-02,-4.84238985983429626e-01,-4.63446105528963204e-01,-5.72379904714647059e-01,-1.77378447998478156e-01,-2.65897708075120476e-01,
1.23848283747299073e-02,-7.56366614574500410e-04,-1.63867341446155140e-02,-1.22423753289159637e-02,-1.31003092973281231e-02,6.28107641555924578e-01,-1.10873941087750705e+00,-5.98097054506843806e-01,-1.45771965085786914e+00,-4.68838185750243552e-01,-5.07312213274358936e-01,-4.78433100604440442e-01,-8.57637763476935683e-02,-1.78746529203948734e-01,-2.67085235367139351e-01,

8,15
8.53086139836106261e-01,1.05518616661224196e+00,1.36715474201333717e-02,1.56066407962402107e-02,1.83897058253567752e-02,1.06753722749674074e+00,1.12851023745912677e-02,1.23260793986099820e-02,9.56405615783526009e-03,3.68014985329687794e-01,4.12531399437241153e-01,4.39043649730194663e-01,1.07998670250494073e-03,4.33793551232536032e-03,1.63433870894040718e-02,
9.94641723446138215e-01,1.05613414030172437e+00,1.82961021585142970e-02,1.83306796005701100e-02,2.12267656698714932e-02,1.06827248142922970e+00,5.67571391452984138e-03,1.26931088613760380e-02,1.00335730974057263e-02,5.30512179066924064e-02,4.25345912276177462e-01,4.67152946303852679e-01,3.62365970664057069e-01,5.94875084607239275e-03,2.28114594217123448e-02,
1.12495608695919591e+00,1.05609873238076934e+00,1.78892214760778198e-02,2.16226446498253531e-02,1.93061302571460591e-02,1.13055676054188092e+00,1.55286093493654520e-02,9.35062228524116690e-03,1.37076875966354560e-02,4.37922433034904857e-01,1.10554260663522766e-01,4.82203084985193819e-01,2.00153480025946949e-03,4.15112162568472887e-01,3.22557262465012484e-02,
1.20820034257455400e+00,1.05574206046228580e+00,1.74466651228672442e-02,2.17649088310775084e-02,2.21756669135715935e-02,1.21028465220764403e+00,2.30460763813159011e-02,1.01888223307549965e-02,1.45869147049159514e-02,5.38664938157118328e-02,1.12312217340134191e-01,4.83095790307843054e-01,4.53535622413159478e-01,4.57214613234248612e-01,4.47142666737001260e-02,
1.21978823708372941e+00,1.05571592847860973e+00,1.76792496432320728e-02,1.64243299737367524e-02,2.17090532949624840e-02,1.22154866265507067e+00,2.09578633201156009e-02,1.31211053261874599e-02,1.67888599360648018e-02,4.64026767708652310e-01,4.75307387252048852e-01,1.67830981498478526e-01,2.70084051826672764e-03,1.12889284137353448e-02,4.68608671107226704e-01,
1.26293280422660126e+00,1.05535090455967873e+00,1.75340135907776917e-02,1.80599696870863552e-02,2.14589109316981642e-02,1.26323021789023282e+00,1.19523049149183602e-01,1.43185031750576244e-02,7.06999337515905324e-02,5.40251856172314429e-02,5.07177087518801417e-01,1.68474896612892111e-01,5.21001885073663407e-01,1.55161635380999911e-02,5.21507134469203382e-01,
1.28262626659861589e+00,1.05447514009575261e+00,1.91919091581700882e-02,2.18339399528762329e-02,2.19800506513330336e-02,1.28220634854917437e+00,5.81376064925342162e-02,4.08377119388269871e-02,1.98273063610215683e-01,4.71794017100508445e-01,1.13135305768645694e-01,1.70011460925711733e-01,5.05974155182085418e-03,5.49474233339123597e-01,5.56086586683076090e-01,
1.29146376356883907e+00,1.05317690839698819e+00,1.76945673309894594e-02,2.12902321084443465e-02,2.19628396831227993e-02,1.29070739695426462e+00,2.23643199447204966e+00,7.14308505653598935e-01,1.74008200803256496e+00,5.50314821088409081e-02,1.14133200843055366e-01,1.70613046530843138e-01,5.68341583342173995e-01,6.06425879386212952e-01,5.59926906061469110e-01,

