1
1
15
0
(8 0
((0,0,0) (7,7,7) (0,0,0))
((8,0,0) (15,7,7) (0,0,0))
((0,8,0) (7,15,7) (0,0,0))
((8,8,0) (15,15,7) (0,0,0))
((0,0,8) (7,7,15) (0,0,0))
((8,0,8) (15,7,15) (0,0,0))
((0,8,8) (7,15,15) (0,0,0))
((8,8,8) (15,15,15) (0,0,0))
)
8
FabOnDisk: Cell_D_00000 0
FabOnDisk: Cell_D_00000 61527
FabOnDisk: Cell_D_00000 123055
FabOnDisk: Cell_D_00000 184583
FabOnDisk: Cell_D_00000 246112
FabOnDisk: Cell_D_00000 307640
FabOnDisk: Cell_D_00000 369169
FabOnDisk: Cell_D_00000 430698

8,15
1.22305271633688598e-02,1.63470386964481018e-02,-1.42944609203673103e-02,-1.24495210455823641e-02,-6.94503315248771493e-03,6.28228510405007601e-01,-2.16487171153791806e-03,6.23307166616768804e-04,2.05468767412176527e-03,-1.00787211261176655e-02,-3.11206329746137773e-02,-9.08096344293454760e-02,-3.87260676424038996e-01,-4.42533792744264798e-01,-4.98746551622731460e-01,
1.20263493049509573e-02,6.47259677364954000e-03,-9.34032409741168343e-03,-1.24245061588746496e-02,-5.79431114737159920e-03,6.28859577041170570e-01,-9.47325387401310587e-03,-4.10990142409476018e-03,-1.90509220102353868e-02,-3.89616206657945496e-01,-3.94144608674689839e-02,-1.12856736091524815e-01,-6.81972289763589645e-02,-4.67136357312551376e-01,-5.37380397897307294e-01,
1.20641711476547637e-02,2.92374777328489746e-03,-1.39361850594237439e-02,-6.41494632834112202e-03,-6.40443975303550683e-03,6.28944829332345412e-01,-1.48357472449433571e-03,-4.77457002050371820e-03,-3.71888512150636563e-02,-1.58283802416148145e-02,-4.25147939435074840e-01,-1.37233331268535014e-01,-4.89467492417752725e-01,-1.41522200077580207e-01,-5.54132439231966867e-01,
1.20807847225257153e-02,1.12764487579024818e-03,-1.23694785655770224e-02,-7.43744663422179000e-03,-8.55919939868795068e-03,6.28422227525240129e-01,-3.26580430231186714e-02,-7.03999748737786646e-03,-3.19100446358244749e-02,-4.50050791784052939e-01,-4.33254858924686126e-01,-1.68271226290959197e-01,-7.02709463283841818e-02,-1.43980529972049048e-01,-5.59115431780285776e-01,
1.21199212893036284e-02,9.82305481189273480e-04,-1.21520113605775686e-02,-1.06211463987082415e-02,-4.66498422048007740e-03,6.28841812309194448e-01,-8.06864032517639988e-03,-1.75374360330628892e-02,-4.88864707452286908e-03,-2.00661090715084089e-02,-6.19897541525960133e-02,-4.52216841004500325e-01,-5.36639951305161178e-01,-5.63492379208355376e-01,-2.28570795136524840e-01,
1.21444578044282384e-02,-9.66716148810524699e-05,-1.36987493639763626e-02,-1.11738990588283217e-02,-5.95303449907651824e-03,6.27418610779329811e-01,-2.11456702446978298e-02,-7.14141207281961288e-01,-7.81755307021084374e-03,-4.70786573654056462e-01,-7.75961580407685259e-02,-4.75914239315509691e-01,-6.86217745350347630e-02,-6.07802553441229909e-01,-2.29980482180268730e-01,
1.22076199090258575e-02,-4.06641204595511389e-04,-1.24405643491197742e-02,-1.02150805553361569e-02,-5.65116126799130713e-03,6.27985996389301859e-01,-2.44332003378485429e-01,-2.44282396692101535e-02,-5.01198611182038789e-01,-3.09484187996256384e-02,-4.73071448709121545e-01,-4.87189964653996832e-01,-5.57910015941816217e-01,-1.46606030962297990e-01,-2.32200999294760901e-01,
1.22621032390831143e-02,-7.66871236432992783e-04,-1.70660841628819671e-02,-1.42062257796043596e-02,-7.72185567620875882e-03,6.28509664167622661e-01,-4.48740392920600195e-02,-1.68289907331692877e-02,-2.50353289746873299e-02,-4.75698037893039105e-01,-5.04929610057915701e-01,-4.88476905814425433e-01,-7.36540375018178706e-02,-1.47892959423864129e-01,-2.33315050140090297e-01,

8,15
1.00046668388020210e+00,1.05566263568387897e+00,1.59006084437474347e-02,1.92858495915091965e-02,2.39585241196888787e-02,1.06791296617145548e+00,1.30180408153594517e-02,1.11978709964271114e-02,1.35184355286012813e-02,4.03361864095885925e-01,4.06430279829475938e-01,4.55207211003745948e-01,1.12617409354933817e-03,3.55128952607403851e-03,1.17761939326700635e-02,
1.11069519593618771e+00,1.05651918574912007e+00,2.05478618633552143e-02,2.08461835736602347e-02,2.46022516150811547e-02,1.11716779270983735e+00,8.60380993235470085e-03,1.20730280217707809e-02,1.71859108173509668e-02,4.40510524687099808e-02,4.29821887911549017e-01,4.62622004123417752e-01,3.98777193635521610e-01,4.73323100353388593e-03,1.58061870232507687e-02,
1.18379636503924801e+00,1.05628555888898057e+00,1.84330485366052052e-02,2.49572012573899202e-02,2.36667026250157592e-02,1.18672011281253287e+00,1.50376029654916508e-02,9.11409318798764648e-03,1.55028677166264527e-02,4.51322139811493050e-01,9.11849236296320004e-02,4.61257981529409111e-01,1.90396590891421524e-03,4.45596873944764327e-01,2.05424754145722144e-02,
1.24001516811240720e+00,1.05596004998469284e+00,2.02942927732785612e-02,2.54594563454241668e-02,2.59220467556536376e-02,1.24114281298819740e+00,4.32941265035182987e-02,1.60010930010338545e-02,1.91468777616438483e-02,4.59122209093467543e-02,9.18823542515543323e-02,4.84750140413892416e-01,4.80180750945342405e-01,4.86470424929522860e-01,2.73934179776524137e-02,
1.24623091844702016e+00,1.05586695756038917e+00,1.98412655066046960e-02,2.13007669706096713e-02,2.80035925759707718e-02,1.24721322392820944e+00,5.12846568136538505e-02,2.18255709155408435e-02,2.86460786409376070e-02,4.62318407882340854e-01,4.90672044091934156e-01,1.46640185419785823e-01,2.46629256801191108e-03,7.93365140364146043e-03,4.81029533763617012e-01,
1.27368810036847280e+00,1.05554332276803486e+00,1.95126939697491258e-02,2.37943347500995384e-02,2.78637778514762222e-02,1.27359142875359166e+00,3.75724203603909970e-02,2.20307534832150827e-02,2.47781993773405290e-01,4.54989595562601129e-02,5.05937085900742489e-01,1.47445832427292145e-01,5.37561895374210619e-01,1.05374204703506461e-02,5.36535651984006323e-01,
1.28451605983906325e+00,1.05482101356350588e+00,2.18514510070845006e-02,2.47760563282629284e-02,2.66283860907563230e-02,1.28410941863446770e+00,6.73595816769489014e-02,6.66892020795064155e-01,8.48572921897929738e-02,4.78148129839738090e-01,9.38160817124791407e-02,1.48820077551368196e-01,4.18402275603410242e-03,5.30400324914726662e-01,5.75598329708868039e-01,
1.29123134052996669e+00,1.05391484884428421e+00,1.88270862618517901e-02,2.41167919947822551e-02,2.69161492478176972e-02,1.29051486815095773e+00,1.32378532410011240e-01,1.62832621311031295e-01,1.57376714798794365e-01,4.77094096302461690e-02,9.49425292128719400e-02,1.49181278264046535e-01,5.79871228948657502e-01,5.94643543816333886e-01,5.96878035386009476e-01,

