1
1
15
0
(8 0
((0,0,0) (7,7,7) (0,0,0))
((8,0,0) (15,7,7) (0,0,0))
((0,8,0) (7,15,7) (0,0,0))
((8,8,0) (15,15,7) (0,0,0))
((0,0,8) (7,7,15) (0,0,0))
((8,0,8) (15,7,15) (0,0,0))
((0,8,8) (7,15,15) (0,0,0))
((8,8,8) (15,15,15) (0,0,0))
)
8
FabOnDisk: Cell_D_00000 0
FabOnDisk: Cell_D_00000 61527
FabOnDisk: Cell_D_00000 123055
FabOnDisk: Cell_D_00000 184583
FabOnDisk: Cell_D_00000 246112
FabOnDisk: Cell_D_00000 307640
FabOnDisk: Cell_D_00000 369169
FabOnDisk: Cell_D_00000 430698

8,15
1.22335612046575830e-02,1.52008187178127498e-02,-1.44080449689129985e-02,-1.22323867809160606e-02,-7.28914082959164142e-03,6.28377904939151688e-01,-2.13277041156230114e-03,5.91761028280628383e-04,5.57688560277398021e-04,-1.03239683005196432e-02,-3.07091956837868447e-02,-8.81608744082626739e-02,-3.90198582684561646e-01,-4.43242862570682905e-01,-5.00458896454652025e-01,
1.20306183979808703e-02,5.97839129877621774e-03,-9.35090399314696119e-03,-1.22930422336669735e-02,-6.16286456978310665e-03,6.28567790449848118e-01,-8.92415581566424580e-03,-5.59468579439227967e-03,-2.16728245371992367e-02,-3.92993090943352885e-01,-3.89292763419449295e-02,-1.09716232603432509e-01,-6.85484892909396792e-02,-4.65993235207621093e-01,-5.37162461622271437e-01,
1.20664101459426361e-02,2.79388902106387756e-03,-1.38486830740034220e-02,-6.70245187684169203e-03,-6.66996678894082873e-03,6.28864390998134626e-01,-1.54675480227330184e-03,-4.46441625354235348e-03,-3.55398131887447316e-02,-1.61146236944944357e-02,-4.26399661348137615e-01,-1.32363942816197344e-01,-4.92077700318413247e-01,-1.39175089806090141e-01,-5.51271046385709118e-01,
1.20799654088740663e-02,1.05598314915902121e-03,-1.24223232501965482e-02,-7.58171834167514682e-03,-8.27532340146928773e-03,6.28393924143927585e-01,-3.48204492957666784e-02,-7.83565592927356475e-03,-3.15892281395791230e-02,-4.51407298304395133e-01,-4.34582939651226685e-01,-1.62630180704288640e-01,-7.06007385529427017e-02,-1.41666490989568877e-01,-5.63426601881717670e-01,
1.21212101891783972e-02,9.38664582197663638e-04,-1.20677297492514171e-02,-1.03565602948716799e-02,-4.75777463853189163e-03,6.28834905940901745e-01,-9.34943936489075061e-03,-1.94447328938365388e-02,-4.95629047319248901e-03,-2.03620593513742683e-02,-6.04603853746991451e-02,-4.51978273241566531e-01,-5.38020369159955103e-01,-5.64921429444241174e-01,-2.24823254287619623e-01,
1.21457799968690983e-02,-1.12334444181278048e-04,-1.37446770553739002e-02,-1.14974985217499125e-02,-6.04864496017741907e-03,6.27425724116315475e-01,-1.97127276516889105e-02,-3.91880217751470505e+00,-7.20898543202749473e-03,-4.71134796549498636e-01,-7.57677510385272451e-02,-4.76689443749005570e-01,-6.88464803032942940e-02,-6.07704335532323059e-01,-2.26448091382937255e-01,
1.22064611826539441e-02,-4.08700498099487993e-04,-1.23797348209203906e-02,-1.02831015628765138e-02,-5.90488590383964149e-03,6.29056855647663893e-01,-5.97630807482802395e-01,-4.16316501958423346e-02,-1.04411540577554462e+00,-3.12064266018871397e-02,-4.71686482588328293e-01,-4.88749368896971181e-01,-5.58081639232651638e-01,-1.43760133669065593e-01,-2.28630392093534140e-01,
1.22604640944957693e-02,-7.72166840709343307e-04,-1.72408214757763696e-02,-1.44659808986589283e-02,-7.85800451465897692e-03,6.28606377685064777e-01,-4.45316599193245066e-02,-1.66979790018966026e-02,-2.43335733884888425e-02,-4.75462267338142397e-01,-5.04358372073151040e-01,-4.91032781960283771e-01,-7.43436381235253185e-02,-1.45406619813026494e-01,-2.29566050769016483e-01,

8,15
1.01047685102879892e+00,1.05566982039847668e+00,1.59137979325670899e-02,1.90814207376544392e-02,2.37993811540214081e-02,1.06792394027307047e+00,1.25957999111232424e-02,1.15008222880724053e-02,1.34904708703211772e-02,4.06075406773800385e-01,4.04482434022992887e-01,4.54686569098795623e-01,1.15450644293886399e-03,3.50482686355913994e-03,1.13317280343672375e-02,
1.11878027278755066e+00,1.05653327964569965e+00,2.06601621601581464e-02,2.11212397258441036e-02,2.44925924608401513e-02,1.12475866408632696e+00,9.22049163583701578e-03,1.24405260567485559e-02,1.73785909766209987e-02,4.41838068226009587e-02,4.33461538451446915e-01,4.60380108311229552e-01,4.00871841557983721e-01,4.67638963026433419e-03,1.52129845158089170e-02,
1.18737127403476306e+00,1.05629689431887619e+00,1.85608886400407368e-02,2.48898675914779183e-02,2.35135741269728027e-02,1.19016516305582698e+00,1.57074533922676660e-02,9.11242168813797618e-03,1.53420318833172413e-02,4.52231178504822584e-01,8.96921717082624081e-02,4.58823539879638087e-01,1.93984255409830023e-03,4.47815472587207664e-01,1.95199663226824568e-02,
1.24232732778041344e+00,1.05596655681717677e+00,2.02311138709555596e-02,2.54297763083476541e-02,2.58563041343996720e-02,1.24338331092957244e+00,4.70526835910405755e-02,1.72827047682513786e-02,1.91474206758727415e-02,4.62298346884030611e-02,9.03642133337407283e-02,4.87716504693193387e-01,4.83470679955147697e-01,4.88831660225694409e-01,2.60434029915861953e-02,
1.24765311963476067e+00,1.05586325436866502e+00,1.98571113898266226e-02,2.15783380807711180e-02,2.80170464816441103e-02,1.24859178421695827e+00,4.62909695351233705e-02,2.44594986516223148e-02,3.00696799227552908e-02,4.62545152391516556e-01,4.90891877483657757e-01,1.44433904790719103e-01,2.50638477617725090e-03,7.72615395498635078e-03,4.80412074483335616e-01,
1.27419564749078362e+00,1.05553826651282634e+00,1.94701157571577632e-02,2.40835566570750011e-02,2.78859079773276959e-02,1.27408331304660227e+00,8.22092684360699932e-01,2.28780564868260733e-02,6.44283064756261070e-01,4.57105373266661688e-02,5.04900344751891827e-01,1.45230747895603723e-01,5.39348751816573380e-01,1.02701730523450333e-02,5.36984630602234114e-01,
1.28470560539006962e+00,1.05484388372112492e+00,2.21331669689659623e-02,2.47716217925541063e-02,2.67497069859439530e-02,1.28429690489197013e+00,7.33282663336957824e-02,1.42055426415344432e+00,6.89406015712355213e-02,4.78121472511511325e-01,9.19582214585477759e-02,1.46383803625407982e-01,4.22040350093796143e-03,5.28271681058106735e-01,5.75789448794491454e-01,
1.29136726281063097e+00,1.05394459350369218e+00,1.88955771261110697e-02,2.40706789245706751e-02,2.69925709971323841e-02,1.29059509596992172e+00,1.28629856411983073e-01,1.51940985320031086e-01,1.42416485611087829e-01,4.80988156949156212e-02,9.33352017402535317e-02,1.46890006656623606e-01,5.79451396962163301e-01,5.93506418534897051e-01,5.99662607718194463e-01,

