1
1
15
0
(8 0
((0,0,0) (7,7,7) (0,0,0))
((8,0,0) (15,7,7) (0,0,0))
((0,8,0) (7,15,7) (0,0,0))
((8,8,0) (15,15,7) (0,0,0))
((0,0,8) (7,7,15) (0,0,0))
((8,0,8) (15,7,15) (0,0,0))
((0,8,8) (7,15,15) (0,0,0))
((8,8,8) (15,15,15) (0,0,0))
)
8
FabOnDisk: Cell_D_00000 0
FabOnDisk: Cell_D_00000 61527
FabOnDisk: Cell_D_00000 123055
FabOnDisk: Cell_D_00000 184583
FabOnDisk: Cell_D_00000 246112
FabOnDisk: Cell_D_00000 307640
FabOnDisk: Cell_D_00000 369169
FabOnDisk: Cell_D_00000 430698

8,15
1.2230527163368860e-02,1.6347038696448102e-02,-1.4294460920367310e-02,-1.2449521045582364e-02,-6.9450331524877149e-03,6.2822851040500760e-01,-2.1648717115379181e-03,6.2330716661676880e-04,2.0546876741217653e-03,-1.0078721126117665e-02,-3.1120632974613777e-02,-9.0809634429345476e-02,-3.8726067642403900e-01,-4.4253379274426480e-01,-4.9874655162273146e-01,
1.2026349304950957e-02,6.4725967736495400e-03,-9.3403240974116834e-03,-1.2424506158874650e-02,-5.7943111473715992e-03,6.2885957704117057e-01,-9.4732538740131059e-03,-4.1099014240947602e-03,-1.9050922010235387e-02,-3.8961620665794550e-01,-3.9414460867468984e-02,-1.1285673609152481e-01,-6.8197228976358965e-02,-4.6713635731255138e-01,-5.3738039789730729e-01,
1.2064171147654764e-02,2.9237477732848975e-03,-1.3936185059423744e-02,-6.4149463283411220e-03,-6.4044397530355068e-03,6.2894482933234541e-01,-1.4835747244943357e-03,-4.7745700205037182e-03,-3.7188851215063656e-02,-1.5828380241614814e-02,-4.2514793943507484e-01,-1.3723333126853501e-01,-4.8946749241775273e-01,-1.4152220007758021e-01,-5.5413243923196687e-01,
1.2080784722525715e-02,1.1276448757902482e-03,-1.2369478565577022e-02,-7.4374466342217900e-03,-8.5591993986879507e-03,6.2842222752524013e-01,-3.2658043023118671e-02,-7.0399974873778665e-03,-3.1910044635824475e-02,-4.5005079178405294e-01,-4.3325485892468613e-01,-1.6827122629095920e-01,-7.0270946328384182e-02,-1.4398052997204905e-01,-5.5911543178028578e-01,
1.2119921289303628e-02,9.8230548118927348e-04,-1.2152011360577569e-02,-1.0621146398708241e-02,-4.6649842204800774e-03,6.2884181230919445e-01,-8.0686403251763999e-03,-1.7537436033062889e-02,-4.8886470745228691e-03,-2.0066109071508409e-02,-6.1989754152596013e-02,-4.5221684100450033e-01,-5.3663995130516118e-01,-5.6349237920835538e-01,-2.2857079513652484e-01,
1.2144457804428238e-02,-9.6671614881052470e-05,-1.3698749363976363e-02,-1.1173899058828322e-02,-5.9530344990765182e-03,6.2741861077932981e-01,-2.1145670244697830e-02,-7.1414120728196129e-01,-7.8175530702108437e-03,-4.7078657365405646e-01,-7.7596158040768526e-02,-4.7591423931550969e-01,-6.8621774535034763e-02,-6.0780255344122991e-01,-2.2998048218026873e-01,
1.2207619909025857e-02,-4.0664120459551139e-04,-1.2440564349119774e-02,-1.0215080555336157e-02,-5.6511612679913071e-03,6.2798599638930186e-01,-2.4433200337848543e-01,-2.4428239669210153e-02,-5.0119861118203879e-01,-3.0948418799625638e-02,-4.7307144870912154e-01,-4.8718996465399683e-01,-5.5791001594181622e-01,-1.4660603096229799e-01,-2.3220099929476090e-01,
1.2262103239083114e-02,-7.6687123643299278e-04,-1.7066084162881967e-02,-1.4206225779604360e-02,-7.7218556762087588e-03,6.2850966416762266e-01,-4.4874039292060020e-02,-1.6828990733169288e-02,-2.5035328974687330e-02,-4.7569803789303911e-01,-5.0492961005791570e-01,-4.8847690581442543e-01,-7.3654037501817871e-02,-1.4789295942386413e-01,-2.3331505014009030e-01,

8,15
1.0004666838802021e+00,1.0556626356838790e+00,1.5900608443747435e-02,1.9285849591509197e-02,2.3958524119688879e-02,1.0679129661714555e+00,1.3018040815359452e-02,1.1197870996427111e-02,1.3518435528601281e-02,4.0336186409588592e-01,4.0643027982947594e-01,4.5520721100374595e-01,1.1261740935493382e-03,3.5512895260740385e-03,1.1776193932670063e-02,
1.1106951959361877e+00,1.0565191857491201e+00,2.0547861863355214e-02,2.0846183573660235e-02,2.4602251615081155e-02,1.1171677927098373e+00,8.6038099323547008e-03,1.2073028021770781e-02,1.7185910817350967e-02,4.4051052468709981e-02,4.2982188791154902e-01,4.6262200412341775e-01,3.9877719363552161e-01,4.7332310035338859e-03,1.5806187023250769e-02,
1.1837963650392480e+00,1.0562855588889806e+00,1.8433048536605205e-02,2.4957201257389920e-02,2.3666702625015759e-02,1.1867201128125329e+00,1.5037602965491651e-02,9.1140931879876465e-03,1.5502867716626453e-02,4.5132213981149305e-01,9.1184923629632000e-02,4.6125798152940911e-01,1.9039659089142152e-03,4.4559687394476433e-01,2.0542475414572214e-02,
1.2400151681124072e+00,1.0559600499846928e+00,2.0294292773278561e-02,2.5459456345424167e-02,2.5922046755653638e-02,1.2411428129881974e+00,4.3294126503518299e-02,1.6001093001033855e-02,1.9146877761643848e-02,4.5912220909346754e-02,9.1882354251554332e-02,4.8475014041389242e-01,4.8018075094534240e-01,4.8647042492952286e-01,2.7393417977652414e-02,
1.2462309184470202e+00,1.0558669575603892e+00,1.9841265506604696e-02,2.1300766970609671e-02,2.8003592575970772e-02,1.2472132239282094e+00,5.1284656813653851e-02,2.1825570915540844e-02,2.8646078640937607e-02,4.6231840788234085e-01,4.9067204409193416e-01,1.4664018541978582e-01,2.4662925680119111e-03,7.9336514036414604e-03,4.8102953376361701e-01,
1.2736881003684728e+00,1.0555433227680349e+00,1.9512693969749126e-02,2.3794334750099538e-02,2.7863777851476222e-02,1.2735914287535917e+00,3.7572420360390997e-02,2.2030753483215083e-02,2.4778199377340529e-01,4.5498959556260113e-02,5.0593708590074249e-01,1.4744583242729215e-01,5.3756189537421062e-01,1.0537420470350646e-02,5.3653565198400632e-01,
1.2845160598390633e+00,1.0548210135635059e+00,2.1851451007084501e-02,2.4776056328262928e-02,2.6628386090756323e-02,1.2841094186344677e+00,6.7359581676948901e-02,6.6689202079506416e-01,8.4857292189792974e-02,4.7814812983973809e-01,9.3816081712479141e-02,1.4882007755136820e-01,4.1840227560341024e-03,5.3040032491472666e-01,5.7559832970886804e-01,
1.2912313405299667e+00,1.0539148488442842e+00,1.8827086261851790e-02,2.4116791994782255e-02,2.6916149247817697e-02,1.2905148681509577e+00,1.3237853241001124e-01,1.6283262131103129e-01,1.5737671479879436e-01,4.7709409630246169e-02,9.4942529212871940e-02,1.4918127826404654e-01,5.7987122894865750e-01,5.9464354381633389e-01,5.9687803538600948e-01,

