1
1
15
0
(8 0
((0,0,0) (7,7,7) (0,0,0))
((8,0,0) (15,7,7) (0,0,0))
((0,8,0) (7,15,7) (0,0,0))
((8,8,0) (15,15,7) (0,0,0))
((0,0,8) (7,7,15) (0,0,0))
((8,0,8) (15,7,15) (0,0,0))
((0,8,8) (7,15,15) (0,0,0))
((8,8,8) (15,15,15) (0,0,0))
)
8
FabOnDisk: Cell_D_00000 0
FabOnDisk: Cell_D_00000 61527
FabOnDisk: Cell_D_00000 123055
FabOnDisk: Cell_D_00000 184583
FabOnDisk: Cell_D_00000 246112
FabOnDisk: Cell_D_00000 307640
FabOnDisk: Cell_D_00000 369169
FabOnDisk: Cell_D_00000 430698

8,15
1.23635146098950762e-02,4.70821134217790649e-02,-1.52800390883671179e-02,-1.55487222483628677e-02,-1.17057240197274703e-02,6.32253444912336926e-01,-2.53763311608289945e-03,-1.75780265956218627e-03,-5.75907709613028779e-04,-9.66783230903400792e-03,-3.85575449036027057e-02,-1.19283082371569607e-01,-3.57937334766874227e-01,-4.05515763441858801e-01,-4.41813769308079030e-01,
1.21408820478982604e-02,2.01639847696923023e-02,-9.86613094367527234e-03,-1.55867906268981459e-02,-1.13332991303393329e-02,6.30855037483121661e-01,-8.66019430221397213e-03,-1.40182168201750078e-03,-1.37704231868541528e-03,-3.63593143845961031e-01,-5.04117584239178532e-02,-1.51526196972946503e-01,-8.41487021650302314e-02,-4.57995283880644033e-01,-5.09085215456157258e-01,
1.21418448232904364e-02,6.45190362696054353e-03,-1.34760184545563294e-02,-1.00743934316473993e-02,-1.04459185340030434e-02,6.27971214481665263e-01,-1.96127643236275549e-03,-1.01904129620540990e-02,-3.27507652382926576e-02,-1.69659543394929738e-02,-4.03288991352429460e-01,-1.93210155773545278e-01,-4.43545890544086219e-01,-1.77077495454769029e-01,-5.67261724437770898e-01,
1.21739784619051914e-02,2.30550705445843086e-03,-1.51834289579369161e-02,-1.36441437477179579e-02,-1.28872677574812591e-02,6.28034155447095843e-01,-1.64731173244747481e-02,-1.01258387501183700e-02,-4.65927564085229090e-02,-4.34967331990924688e-01,-4.09515167739187724e-01,-2.39535786032848558e-01,-8.60695361097706529e-02,-1.78427228424853729e-01,-5.94287838328909968e-01,
1.21889194067415028e-02,1.87947130350153441e-03,-1.39152255517159262e-02,-1.51738319063210586e-02,-1.09487911128734062e-02,6.28392842613427760e-01,-2.96501901431064788e-03,-2.53155163375399297e-02,-6.55843479849136084e-03,-2.27781258399123790e-02,-8.92445569232771102e-02,-4.41288473593985708e-01,-5.17610130370899424e-01,-5.26424469360565528e-01,-2.71247234464523812e-01,
1.22178914884700004e-02,3.35351382958665818e-04,-1.42811266189342891e-02,-1.45485761050099457e-02,-1.08562227807618792e-02,6.28637732913631453e-01,-8.41253095643731269e-02,-1.61572954975446770e-01,-2.40454091599081043e-02,-4.61699194680128988e-01,-1.14693124256029733e-01,-4.57011835589154369e-01,-8.59705402417670628e-02,-5.97857701625296833e-01,-2.73791232702570386e-01,
1.23117353723227671e-02,-4.27003137584322154e-04,-1.38544446853911211e-02,-1.02215821395032595e-02,-9.71063502294204628e-03,6.28086542065985354e-01,-1.31643174539175928e-01,-2.21134225872027072e-02,-2.03781839145498606e-02,-3.89742974351973484e-02,-4.85240177359856084e-01,-4.58611890710034831e-01,-5.75279445607431716e-01,-1.81859876060763814e-01,-2.72882338029561855e-01,
1.23971777115307134e-02,-7.78100332271236886e-04,-1.66127322274109007e-02,-1.18054786653237938e-02,-1.36473985463328399e-02,6.27670782048765918e-01,-2.06202645909958682e-01,-4.03418925043874041e-02,-2.42718647139258420e-01,-4.70298198135341461e-01,-5.06659402161525052e-01,-4.85097569566765696e-01,-8.79787389381928159e-02,-1.83541331689733411e-01,-2.73942015024444374e-01,

8,15
8.24453623203629915e-01,1.05511038371474175e+00,1.33592368975759077e-02,1.56498362219022330e-02,1.76183599169206888e-02,1.06747389832463679e+00,1.06862257742928440e-02,1.20778276049455270e-02,9.65652737381758781e-03,3.68374331065423943e-01,4.10242568152417775e-01,4.33284499972126480e-01,1.07311641598140562e-03,4.42825467535798607e-03,1.74260747120851059e-02,
9.73044122202994188e-01,1.05608511404234551e+00,1.85090841426766850e-02,1.82849141229695540e-02,2.07827062232470959e-02,1.06823245299616421e+00,5.42936554214204330e-03,1.32762200789057257e-02,1.00035835845131565e-02,5.45822045400482236e-02,4.26649894213117942e-01,4.65336881897356502e-01,3.55170591543464031e-01,6.12573355524526769e-03,2.45640078567622849e-02,
1.11077595152686182e+00,1.05607401740416407e+00,1.82013520303833526e-02,2.10778989038332629e-02,1.86203322003695368e-02,1.11722785515382239e+00,1.51981422972983574e-02,1.02073470127999680e-02,1.35980273125022137e-02,4.33851264683958404e-01,1.12576787057406091e-01,4.84783964208780616e-01,2.01440135602505739e-03,4.08683832840819217e-01,3.50590658162724111e-02,
1.20099684389604411e+00,1.05569810423918353e+00,1.72043871271832551e-02,2.12698027109427465e-02,2.15904695307231435e-02,1.20330235095050253e+00,2.17990948291581707e-02,1.09445062958341312e-02,1.40432638028884886e-02,5.54131974653918127e-02,1.15327715428956534e-01,4.87313252146156561e-01,4.47720512554503070e-01,4.52053663356803137e-01,4.90382604990698967e-02,
1.21565005352820621e+00,1.05573829233772520e+00,1.76032154788941866e-02,1.62098561636997811e-02,2.15098596882958328e-02,1.21752952483170773e+00,2.03143321897134299e-02,1.31301891208258116e-02,1.43790725025415497e-02,4.63850981791937733e-01,4.72128771537387082e-01,1.72338070363019957e-01,2.76670928734828753e-03,1.19358204781215387e-02,4.66129466416314753e-01,
1.26175410085829798e+00,1.05533321336110841e+00,1.73856855531195828e-02,1.70070131940752677e-02,2.11364705781568220e-02,1.26208945224125668e+00,1.10748474966730057e-01,1.36301595047357664e-02,5.77334925196267557e-02,5.56538076198404147e-02,5.06791574328618211e-01,1.72385633011738731e-01,5.19141283848463253e-01,1.65608011306938897e-02,5.18655922877719111e-01,
1.28260285036604649e+00,1.05445261668646406e+00,1.91062005053508135e-02,2.13322692454634769e-02,2.15571828902751672e-02,1.28217584722846212e+00,5.85403194444910902e-02,4.06012127862377115e-02,2.64907718100351186e-01,4.73205437458964984e-01,1.16075042007317941e-01,1.74163310067057875e-01,5.25674807192576948e-03,5.51979327119933139e-01,5.50578241057666506e-01,
1.29161329818077153e+00,1.05303820622349975e+00,1.79214530751359569e-02,2.07311402094212810e-02,2.16221440245368199e-02,1.29083519784850020e+00,3.65093548291986814e-01,2.11897398653285407e+00,1.06841148900655414e+00,5.65055623912809751e-02,1.17030963277760774e-01,1.74866353047170381e-01,5.66314375007083259e-01,6.07714076738727793e-01,5.61012980695004049e-01,

