1
1
15
0
(8 0
((0,0,0) (7,7,7) (0,0,0))
((8,0,0) (15,7,7) (0,0,0))
((0,8,0) (7,15,7) (0,0,0))
((8,8,0) (15,15,7) (0,0,0))
((0,0,8) (7,7,15) (0,0,0))
((8,0,8) (15,7,15) (0,0,0))
((0,8,8) (7,15,15) (0,0,0))
((8,8,8) (15,15,15) (0,0,0))
)
8
FabOnDisk: Cell_D_00000 0
FabOnDisk: Cell_D_00000 61527
FabOnDisk: Cell_D_00000 123055
FabOnDisk: Cell_D_00000 184583
FabOnDisk: Cell_D_00000 246112
FabOnDisk: Cell_D_00000 307640
FabOnDisk: Cell_D_00000 369169
FabOnDisk: Cell_D_00000 430698

8,15
1.23291811040566468e-02,4.07477084552170660e-02,-1.41606319606769008e-02,-1.42335532979233816e-02,-9.05214704327753084e-03,6.28991678664454601e-01,-2.31430803173308768e-03,-6.88545321494898562e-04,6.17071613542422015e-04,-9.75799163679025305e-03,-3.52436696231111651e-02,-1.19220464271325710e-01,-3.63970601914490488e-01,-4.11457521843488883e-01,-4.54183210299142603e-01,
1.21054019412253060e-02,1.73989244704554138e-02,-9.76857373033266502e-03,-1.41262638813336189e-02,-8.77771499028594249e-03,6.29003380329476003e-01,-9.34579829086940733e-03,-9.15852728675265837e-04,-1.68936528465138196e-04,-3.65631902640570661e-01,-4.57671614212916480e-02,-1.50471044356732309e-01,-8.03467485117373564e-02,-4.58767561163582915e-01,-5.17363132463101838e-01,
1.21166336068983926e-02,5.99558945585669523e-03,-1.38916948589932823e-02,-9.01916382158546304e-03,-8.04037568806614117e-03,6.28320928020337566e-01,-1.67953651058701920e-03,-8.85606180786254957e-03,-3.39417132631747998e-02,-1.66296086828007401e-02,-4.07128227051728797e-01,-1.88798512776301802e-01,-4.48061531919406897e-01,-1.68202870200938492e-01,-5.68582874204659694e-01,
1.21464716450496064e-02,2.22501481184970203e-03,-1.43709484669380192e-02,-1.23195327811604100e-02,-1.15514004528792687e-02,6.27982034525308874e-01,-1.64800314699953022e-02,-8.64276870344306627e-03,-4.86746780491844264e-02,-4.35579359575921199e-01,-4.15935824565007661e-01,-2.33129477628037984e-01,-8.32009342879796165e-02,-1.69173388717692330e-01,-5.92647721576657016e-01,
1.21789193245283329e-02,1.64351328425225616e-03,-1.28652527632730981e-02,-1.35836688080265694e-02,-8.69195840466013489e-03,6.29086857000235034e-01,-2.79514048652898051e-03,-2.33382776385570936e-02,-8.95133727949000250e-03,-2.27196578100357996e-02,-8.12955563291001826e-02,-4.45107126151684185e-01,-5.23674456202075977e-01,-5.37069157727359414e-01,-2.69309327817122801e-01,
1.22050569566045826e-02,2.15920666436703545e-04,-1.38444683854574962e-02,-1.28133776179445123e-02,-8.95457271827539494e-03,6.28604467235017506e-01,-1.03487381086856761e-01,-2.61554947726529263e-01,-1.62653170193207477e-02,-4.63505610938848234e-01,-1.04054695470026354e-01,-4.60058492141704911e-01,-8.26769081975069209e-02,-6.01894183961270701e-01,-2.70400726347896359e-01,
1.22904201650798767e-02,-4.23654936564071502e-04,-1.34438899898936346e-02,-8.98869654987845268e-03,-8.42094942948057312e-03,6.28642907903085302e-01,-1.16029581971433926e-01,-1.96900431629751724e-02,-1.18870873882369298e-02,-3.78697806820236585e-02,-4.83136821686808049e-01,-4.61635948210229352e-01,-5.71857815588622476e-01,-1.72958191167841446e-01,-2.70993113183329415e-01,
1.23659926514967291e-02,-7.74047590751502225e-04,-1.60334228563328712e-02,-1.22597870085805298e-02,-1.21859306381496401e-02,6.27663280893734798e-01,-4.46656029260213416e-02,-2.11311305360956415e-02,-3.38366006909655848e-02,-4.68636750145462300e-01,-5.08148207557220344e-01,-4.82239438924063457e-01,-8.57420517899940143e-02,-1.74480155710722729e-01,-2.72391438958938359e-01,

8,15
8.52302328379577645e-01,1.05528319815823757e+00,1.41733541066907196e-02,1.62408357100138970e-02,1.94849373462152725e-02,1.06761237926229424e+00,1.18989139537528949e-02,1.32018653272639036e-02,1.01133176251729604e-02,3.67998220819302002e-01,4.10797489782035119e-01,4.40130561175378965e-01,1.08294672228916684e-03,4.02310274941545393e-03,1.72954033899750288e-02,
9.93574103114639673e-01,1.05622192484090704e+00,1.84534323827602494e-02,1.99602266756621002e-02,2.21722714568094170e-02,1.06834064266054907e+00,5.78848129164623824e-03,1.37204194165312914e-02,1.06778654579070924e-02,5.28299524693475742e-02,4.22795489974471306e-01,4.68987383963731130e-01,3.62045038374881667e-01,5.51076295575373722e-03,2.41414700201034484e-02,
1.11812290291539784e+00,1.05615128843836237e+00,1.84046639860976045e-02,2.26783193948607575e-02,2.04510761093620909e-02,1.12411849237125461e+00,1.58482833617222055e-02,8.81556638823479885e-03,1.45373544729215532e-02,4.35990339983790887e-01,1.07098265134928164e-01,4.84588744340226363e-01,1.97585403739926248e-03,4.11448884883628629e-01,3.36069021616231117e-02,
1.20360676140614564e+00,1.05578744609299502e+00,1.84887891684498533e-02,2.27898202524948121e-02,2.34292628498492007e-02,1.20583177621799531e+00,2.28820804254682986e-02,1.03576280601562071e-02,1.56350097300080870e-02,5.38917969820304210e-02,1.09117996450265056e-01,4.86415659567168257e-01,4.48946443062624490e-01,4.56024602773060339e-01,4.65807338616883518e-02,
1.22399853414422100e+00,1.05572608041035632e+00,1.80873119397005691e-02,1.70665143367635871e-02,2.25427557546327949e-02,1.22564204742847327e+00,2.21276180726996466e-02,1.40657614942306664e-02,1.98802751305685969e-02,4.64835372531730462e-01,4.78401390151397543e-01,1.70973749345435078e-01,2.76831136597375594e-03,1.06952700969712676e-02,4.73863498135278949e-01,
1.26490998011885081e+00,1.05534643964895358e+00,1.78973007068089565e-02,1.86588515149103649e-02,2.23597471782947740e-02,1.26512590078528753e+00,1.63690764542488487e-01,1.56016523093597311e-02,8.30645257991868141e-02,5.41447661887096560e-02,5.08145620225065153e-01,1.71640490600075968e-01,5.24214049715752139e-01,1.46919560824125342e-02,5.24411848299440764e-01,
1.28273420023033724e+00,1.05448893982171410e+00,1.95777396691385261e-02,2.26677735520296603e-02,2.30519873139287089e-02,1.28231054529377309e+00,6.30311548641549202e-02,1.19104279392698423e-01,4.14652922313334893e-01,4.71536812990620391e-01,1.10420465075292407e-01,1.73168622613145085e-01,5.11136935131944851e-03,5.47116594787325217e-01,5.54432938012524024e-01,
1.29170877854868582e+00,1.05322371827770334e+00,1.77539055704621224e-02,2.20932429677983960e-02,2.30108029565663647e-02,1.29093473095793443e+00,1.34001043582233664e-01,3.30295098017490907e-01,2.72616669059636996e-01,5.51947737757804702e-02,1.11509120496385283e-01,1.73856849264980295e-01,5.67953910734376288e-01,6.06429333199203557e-01,5.57192940040049378e-01,

