1
1
15
0
(8 0
((0,0,0) (7,7,7) (0,0,0))
((8,0,0) (15,7,7) (0,0,0))
((0,8,0) (7,15,7) (0,0,0))
((8,8,0) (15,15,7) (0,0,0))
((0,0,8) (7,7,15) (0,0,0))
((8,0,8) (15,7,15) (0,0,0))
((0,8,8) (7,15,15) (0,0,0))
((8,8,8) (15,15,15) (0,0,0))
)
8
FabOnDisk: Cell_D_00000 0
FabOnDisk: Cell_D_00000 61527
FabOnDisk: Cell_D_00000 123055
FabOnDisk: Cell_D_00000 184583
FabOnDisk: Cell_D_00000 246112
FabOnDisk: Cell_D_00000 307640
FabOnDisk: Cell_D_00000 369169
FabOnDisk: Cell_D_00000 430698

8,15
1.2329181104056647e-02,4.0747708455217066e-02,-1.4160631960676901e-02,-1.4233553297923382e-02,-9.0521470432775308e-03,6.2899167866445460e-01,-2.3143080317330877e-03,-6.8854532149489856e-04,6.1707161354242202e-04,-9.7579916367902531e-03,-3.5243669623111165e-02,-1.1922046427132571e-01,-3.6397060191449049e-01,-4.1145752184348888e-01,-4.5418321029914260e-01,
1.2105401941225306e-02,1.7398924470455414e-02,-9.7685737303326650e-03,-1.4126263881333619e-02,-8.7777149902859425e-03,6.2900338032947600e-01,-9.3457982908694073e-03,-9.1585272867526584e-04,-1.6893652846513820e-04,-3.6563190264057066e-01,-4.5767161421291648e-02,-1.5047104435673231e-01,-8.0346748511737356e-02,-4.5876756116358292e-01,-5.1736313246310184e-01,
1.2116633606898393e-02,5.9955894558566952e-03,-1.3891694858993282e-02,-9.0191638215854630e-03,-8.0403756880661412e-03,6.2832092802033757e-01,-1.6795365105870192e-03,-8.8560618078625496e-03,-3.3941713263174800e-02,-1.6629608682800740e-02,-4.0712822705172880e-01,-1.8879851277630180e-01,-4.4806153191940690e-01,-1.6820287020093849e-01,-5.6858287420465969e-01,
1.2146471645049606e-02,2.2250148118497020e-03,-1.4370948466938019e-02,-1.2319532781160410e-02,-1.1551400452879269e-02,6.2798203452530887e-01,-1.6480031469995302e-02,-8.6427687034430663e-03,-4.8674678049184426e-02,-4.3557935957592120e-01,-4.1593582456500766e-01,-2.3312947762803798e-01,-8.3200934287979617e-02,-1.6917338871769233e-01,-5.9264772157665702e-01,
1.2178919324528333e-02,1.6435132842522562e-03,-1.2865252763273098e-02,-1.3583668808026569e-02,-8.6919584046601349e-03,6.2908685700023503e-01,-2.7951404865289805e-03,-2.3338277638557094e-02,-8.9513372794900025e-03,-2.2719657810035800e-02,-8.1295556329100183e-02,-4.4510712615168418e-01,-5.2367445620207598e-01,-5.3706915772735941e-01,-2.6930932781712280e-01,
1.2205056956604583e-02,2.1592066643670354e-04,-1.3844468385457496e-02,-1.2813377617944512e-02,-8.9545727182753949e-03,6.2860446723501751e-01,-1.0348738108685676e-01,-2.6155494772652926e-01,-1.6265317019320748e-02,-4.6350561093884823e-01,-1.0405469547002635e-01,-4.6005849214170491e-01,-8.2676908197506921e-02,-6.0189418396127070e-01,-2.7040072634789636e-01,
1.2290420165079877e-02,-4.2365493656407150e-04,-1.3443889989893635e-02,-8.9886965498784527e-03,-8.4209494294805731e-03,6.2864290790308530e-01,-1.1602958197143393e-01,-1.9690043162975172e-02,-1.1887087388236930e-02,-3.7869780682023658e-02,-4.8313682168680805e-01,-4.6163594821022935e-01,-5.7185781558862248e-01,-1.7295819116784145e-01,-2.7099311318332941e-01,
1.2365992651496729e-02,-7.7404759075150222e-04,-1.6033422856332871e-02,-1.2259787008580530e-02,-1.2185930638149640e-02,6.2766328089373480e-01,-4.4665602926021342e-02,-2.1131130536095642e-02,-3.3836600690965585e-02,-4.6863675014546230e-01,-5.0814820755722034e-01,-4.8223943892406346e-01,-8.5742051789994014e-02,-1.7448015571072273e-01,-2.7239143895893836e-01,

8,15
8.5230232837957765e-01,1.0552831981582376e+00,1.4173354106690720e-02,1.6240835710013897e-02,1.9484937346215273e-02,1.0676123792622942e+00,1.1898913953752895e-02,1.3201865327263904e-02,1.0113317625172960e-02,3.6799822081930200e-01,4.1079748978203512e-01,4.4013056117537896e-01,1.0829467222891668e-03,4.0231027494154539e-03,1.7295403389975029e-02,
9.9357410311463967e-01,1.0562219248409070e+00,1.8453432382760249e-02,1.9960226675662100e-02,2.2172271456809417e-02,1.0683406426605491e+00,5.7884812916462382e-03,1.3720419416531291e-02,1.0677865457907092e-02,5.2829952469347574e-02,4.2279548997447131e-01,4.6898738396373113e-01,3.6204503837488167e-01,5.5107629557537372e-03,2.4141470020103448e-02,
1.1181229029153978e+00,1.0561512884383624e+00,1.8404663986097605e-02,2.2678319394860758e-02,2.0451076109362091e-02,1.1241184923712546e+00,1.5848283361722205e-02,8.8155663882347989e-03,1.4537354472921553e-02,4.3599033998379089e-01,1.0709826513492816e-01,4.8458874434022636e-01,1.9758540373992625e-03,4.1144888488362863e-01,3.3606902161623112e-02,
1.2036067614061456e+00,1.0557874460929950e+00,1.8488789168449853e-02,2.2789820252494812e-02,2.3429262849849201e-02,1.2058317762179953e+00,2.2882080425468299e-02,1.0357628060156207e-02,1.5635009730008087e-02,5.3891796982030421e-02,1.0911799645026506e-01,4.8641565956716826e-01,4.4894644306262449e-01,4.5602460277306034e-01,4.6580733861688352e-02,
1.2239985341442210e+00,1.0557260804103563e+00,1.8087311939700569e-02,1.7066514336763587e-02,2.2542755754632795e-02,1.2256420474284733e+00,2.2127618072699647e-02,1.4065761494230666e-02,1.9880275130568597e-02,4.6483537253173046e-01,4.7840139015139754e-01,1.7097374934543508e-01,2.7683113659737559e-03,1.0695270096971268e-02,4.7386349813527895e-01,
1.2649099801188508e+00,1.0553464396489536e+00,1.7897300706808957e-02,1.8658851514910365e-02,2.2359747178294774e-02,1.2651259007852875e+00,1.6369076454248849e-01,1.5601652309359731e-02,8.3064525799186814e-02,5.4144766188709656e-02,5.0814562022506515e-01,1.7164049060007597e-01,5.2421404971575214e-01,1.4691956082412534e-02,5.2441184829944076e-01,
1.2827342002303372e+00,1.0544889398217141e+00,1.9577739669138526e-02,2.2667773552029660e-02,2.3051987313928709e-02,1.2823105452937731e+00,6.3031154864154920e-02,1.1910427939269842e-01,4.1465292231333489e-01,4.7153681299062039e-01,1.1042046507529241e-01,1.7316862261314508e-01,5.1113693513194485e-03,5.4711659478732522e-01,5.5443293801252402e-01,
1.2917087785486858e+00,1.0532237182777033e+00,1.7753905570462122e-02,2.2093242967798396e-02,2.3010802956566365e-02,1.2909347309579344e+00,1.3400104358223366e-01,3.3029509801749091e-01,2.7261666905963700e-01,5.5194773775780470e-02,1.1150912049638528e-01,1.7385684926498030e-01,5.6795391073437629e-01,6.0642933319920356e-01,5.5719294004004938e-01,

