1
1
15
0
(8 0
((0,0,0) (7,7,7) (0,0,0))
((8,0,0) (15,7,7) (0,0,0))
((0,8,0) (7,15,7) (0,0,0))
((8,8,0) (15,15,7) (0,0,0))
((0,0,8) (7,7,15) (0,0,0))
((8,0,8) (15,7,15) (0,0,0))
((0,8,8) (7,15,15) (0,0,0))
((8,8,8) (15,15,15) (0,0,0))
)
8
FabOnDisk: Cell_D_00000 0
FabOnDisk: Cell_D_00000 61527
FabOnDisk: Cell_D_00000 123055
FabOnDisk: Cell_D_00000 184583
FabOnDisk: Cell_D_00000 246112
FabOnDisk: Cell_D_00000 307640
FabOnDisk: Cell_D_00000 369169
FabOnDisk: Cell_D_00000 430698

8,15
1.23303294542930677e-02,3.78962339220893230e-02,-1.38738124512323702e-02,-1.42796171745646228e-02,-9.01643207636892638e-03,6.28181458864350395e-01,-2.16649262539500825e-03,-7.72763347229755027e-04,4.65089804002312662e-04,-1.00523330397388477e-02,-3.47226558172867850e-02,-1.16059362545527733e-01,-3.67762151703771800e-01,-4.14822162773193004e-01,-4.58898879629240197e-01,
1.21046869483875004e-02,1.58596141804779253e-02,-9.66145944742692261e-03,-1.41657621224639020e-02,-8.68452488888896319e-03,6.28228303401030974e-01,-9.54351307725548499e-03,-8.93411586971849694e-04,-2.63240049563009005e-04,-3.65607303371659920e-01,-4.51697281277367857e-02,-1.46823644904001516e-01,-8.02157849323338612e-02,-4.60651126568246139e-01,-5.20802756945525691e-01,
1.21152407216027578e-02,5.64179095565482333e-03,-1.39870804396239057e-02,-9.09827685234517076e-03,-8.33923815813883591e-03,6.28321111196123550e-01,-1.65858893274160044e-03,-8.61619403557300698e-03,-3.54450372622085799e-02,-1.69939219451690215e-02,-4.08701633316351232e-01,-1.82863348077378918e-01,-4.51904174758442911e-01,-1.65783944899794089e-01,-5.67909418063071936e-01,
1.21461994641111452e-02,2.09647777101611664e-03,-1.41146103528076092e-02,-1.19951126869751856e-02,-1.15769926416145891e-02,6.27976893674306869e-01,-1.69534536520749082e-02,-8.41405653121223181e-03,-4.60132775791345441e-02,-4.37507149884752700e-01,-4.17614463569884187e-01,-2.26505879865027293e-01,-8.37602500097261171e-02,-1.66831884517156498e-01,-5.89411400302878974e-01,
1.21820353430752270e-02,1.60750184139570713e-03,-1.28093212472860651e-02,-1.35312593893891255e-02,-8.48642586698245688e-03,6.29185802828348351e-01,-2.73906385870737465e-03,-2.15314565081600393e-02,-8.97076079721598890e-03,-2.30142456536414977e-02,-7.87788104618674240e-02,-4.45948013588966408e-01,-5.24901805033965552e-01,-5.38631507456156733e-01,-2.65429510711395089e-01,
1.22098142824208812e-02,1.86350916483104986e-04,-1.38257263780045842e-02,-1.27952933682217909e-02,-8.99508274028489388e-03,6.28674361400399673e-01,-1.07637512828168136e-01,-3.07378536811394043e-01,-1.60092155378239002e-02,-4.63702925127819854e-01,-1.01053001287000135e-01,-4.62116214524009472e-01,-8.30116937348322897e-02,-6.02563009074515765e-01,-2.66325006231670935e-01,
1.22902435136820389e-02,-4.18354966557952504e-04,-1.33153648813837747e-02,-9.23671789625737233e-03,-8.52392919113282438e-03,6.28355317916478251e-01,-4.97849737255230546e-02,-1.90057031244485752e-02,-1.24867446130292326e-02,-3.80497220400286690e-02,-4.81620053867118370e-01,-4.64267791839153676e-01,-5.72238861970372437e-01,-1.69981709942135462e-01,-2.66928686458594910e-01,
1.23647804910780312e-02,-7.62614190153553494e-04,-1.60398183371744732e-02,-1.26685691145873511e-02,-1.21947545385259239e-02,6.28042469331735576e-01,-4.52557575001435730e-02,-2.01280123500967786e-02,-3.22897824895797964e-02,-4.68301720456381965e-01,-5.08107367004209332e-01,-4.78445288878551589e-01,-8.62500518173113795e-02,-1.71587413239384562e-01,-2.68320773204392848e-01,

8,15
8.65981962109672487e-01,1.05527761996604830e+00,1.42048021951606748e-02,1.62346992265548599e-02,1.94910307151226897e-02,1.06760816918899182e+00,1.21146844764453438e-02,1.32358035254589515e-02,9.81483169375465050e-03,3.68526319047454198e-01,4.11177757739945471e-01,4.42481717747747194e-01,1.11579024851824870e-03,3.96022865036565856e-03,1.66208891952385404e-02,
1.00637575228107234e+00,1.05622012308903490e+00,1.81882622081457439e-02,1.98097564979307257e-02,2.20682946794414914e-02,1.06833954413468035e+00,6.02082856989992997e-03,1.36729536416895902e-02,1.11962143603136881e-02,5.31208517409023223e-02,4.21390642611576993e-01,4.69691407670379646e-01,3.65515100201784127e-01,5.43504664424135364e-03,2.32330443190991755e-02,
1.12425741135803858e+00,1.05615609425687818e+00,1.81857417438263981e-02,2.28499926158795066e-02,2.03977257003548247e-02,1.12989920231369334e+00,1.57528318977808932e-02,8.32867547298943474e-03,1.44793656324648089e-02,4.37791835084165692e-01,1.05776361429196913e-01,4.82810836274806310e-01,2.02119533715858181e-03,4.14230424598073743e-01,3.19108239257690218e-02,
1.20792591668030447e+00,1.05578477551129435e+00,1.85928209652740824e-02,2.29347136053360649e-02,2.34529704676844503e-02,1.21002239445132065e+00,2.36615857002888917e-02,9.48599547510649461e-03,1.55730928208209721e-02,5.42005879585008912e-02,1.07322429136627442e-01,4.83704635526646887e-01,4.53260676060373124e-01,4.59119907746606271e-01,4.43058053540370395e-02,
1.22527686606976771e+00,1.05573296997529775e+00,1.81124758549117762e-02,1.71163943835116530e-02,2.22935502084923957e-02,1.22688436791116340e+00,2.25924216926290423e-02,1.43821890419856199e-02,2.09933724492002219e-02,4.65293636127971866e-01,4.79311282305376285e-01,1.68752217694229489e-01,2.80418401438748202e-03,1.03027400509494126e-02,4.74349455197446979e-01,
1.26565257622599603e+00,1.05534948497945047e+00,1.80408976702503485e-02,1.88552685980333742e-02,2.25470247419779848e-02,1.26583892714247903e+00,1.72383151704754101e-01,1.57114674054576707e-02,9.86194962470660491e-02,5.43611701958156002e-02,5.08138640666033536e-01,1.69442536266392163e-01,5.25510375831946819e-01,1.41754599563379269e-02,5.26274110428932573e-01,
1.28262094666910120e+00,1.05452622119374317e+00,1.95108428905413772e-02,2.28376081095540036e-02,2.27704469300275131e-02,1.28220259170254325e+00,6.03341384685902454e-02,9.24759957186650078e-02,2.52426793667670735e-01,4.71796257056700252e-01,1.08488809688998294e-01,1.70624807808272522e-01,5.12997274056795939e-03,5.44159011924621128e-01,5.57066444872109878e-01,
1.29167231512418401e+00,1.05327551769031946e+00,1.74694000707887320e-02,2.22685442739705558e-02,2.27523874815948948e-02,1.29090970093403046e+00,5.38623574046935119e+03,2.31763476621622885e+03,6.06012229081599253e+03,5.54330778973632435e-02,1.09644900241242127e-01,1.71300476213803399e-01,5.67653695611160747e-01,6.05363942990075232e-01,5.61134283302968218e-01,

