1
1
15
0
(8 0
((0,0,0) (7,7,7) (0,0,0))
((8,0,0) (15,7,7) (0,0,0))
((0,8,0) (7,15,7) (0,0,0))
((8,8,0) (15,15,7) (0,0,0))
((0,0,8) (7,7,15) (0,0,0))
((8,0,8) (15,7,15) (0,0,0))
((0,8,8) (7,15,15) (0,0,0))
((8,8,8) (15,15,15) (0,0,0))
)
8
FabOnDisk: Cell_D_00000 0
FabOnDisk: Cell_D_00000 61527
FabOnDisk: Cell_D_00000 123055
FabOnDisk: Cell_D_00000 184583
FabOnDisk: Cell_D_00000 246112
FabOnDisk: Cell_D_00000 307640
FabOnDisk: Cell_D_00000 369169
FabOnDisk: Cell_D_00000 430698

8,15
1.20423229598041141e-02,7.28519383985387278e-03,-1.44817647439806144e-02,-9.19434105102159491e-03,-6.83064114082410946e-03,6.32284837422849799e-01,-1.80397867642434029e-03,-4.77851679968130817e-03,-1.50205250292640303e-02,-1.04304872780224076e-02,-2.76956664208199213e-02,-6.93502831690041149e-02,-4.36618743604548165e-01,-4.43856172791201820e-01,-5.07982272347889063e-01,
1.18442913050013539e-02,3.03399327960370826e-03,-8.18412160642417209e-03,-1.02405837180978825e-02,-5.16060136991278867e-03,6.31123725801006064e-01,-1.31186034798102778e-02,-1.56261940274056571e-02,-2.97618300274631875e-02,-4.13227964432706207e-01,-3.45350793469591522e-02,-8.53676457983163633e-02,-5.79452673819598890e-02,-4.93423986166762085e-01,-5.22552778168825061e-01,
1.19183617711147525e-02,1.78757928674434167e-03,-1.29981546284621552e-02,-5.19771221400814731e-03,-5.06093916050784354e-03,6.28702086290359619e-01,-2.04728910681475310e-03,-5.38874578221808145e-03,-2.29167824413174237e-02,-1.52626723896331726e-02,-4.38607271651533348e-01,-9.90473701371483994e-02,-5.11575155077582555e-01,-1.19008534698946122e-01,-5.33104144726552764e-01,
1.18920812869427201e-02,4.95716495439050132e-04,-1.24877126394709829e-02,-6.83513522929183118e-03,-6.56966064079051500e-03,6.28548504082558579e-01,-6.03389306798104430e-02,-2.22856221468935370e-02,-9.15361916668462200e-02,-4.60147928829483299e-01,-4.46515410761964437e-01,-1.20967118238235097e-01,-5.95877928547709837e-02,-1.20826837534890236e-01,-5.94918036357209745e-01,
1.19877342373006530e-02,5.10881058818305075e-04,-1.20889942593035305e-02,-7.04453307947496520e-03,-2.47122136102326771e-03,6.29030134747999625e-01,-1.52176568781667333e-02,-3.36144535832911748e-02,-2.82096596350306806e-03,-1.86617631124777646e-02,-4.96387088910213783e-02,-4.48660721021118758e-01,-5.40476170259136524e-01,-5.75509818756680502e-01,-1.92312314819942765e-01,
1.19577569382684872e-02,-2.75736974839047543e-04,-1.21691324582529747e-02,-1.31136127462398305e-02,-2.30403219857557365e-03,6.28411043109436851e-01,-1.54523949042839632e-02,-3.96826392968414154e+00,-2.82956021925221107e-03,-4.76343675979571612e-01,-6.13634465586025413e-02,-4.78556138218597715e-01,-5.96033382075343982e-02,-6.01245334182867963e-01,-1.92042105331518026e-01,
1.20597322432119437e-02,-1.05763138822502684e-03,-1.17171636172431620e-02,-9.12640512007033798e-03,-3.10164483755706686e-03,6.28698757952186771e-01,-2.75508179697923627e-01,-1.37192090383652168e-02,-1.44483545903511557e+00,-2.69848569173648870e-02,-4.62013800666467467e-01,-4.95143392340712030e-01,-5.68652889789069471e-01,-1.22476563397523136e-01,-1.98063534168340466e-01,
1.20674316207481543e-02,-8.30839069435506923e-04,-1.67435346353787540e-02,-1.43829636375695565e-02,-4.98151052246565296e-03,6.27529941807235536e-01,-2.78753857955820264e-02,-3.18028326717726739e-01,-5.12381928211353310e-01,-4.80649391145718363e-01,-4.97419367786048172e-01,-5.08563781483908128e-01,-6.50200032810111239e-02,-1.25230455032254356e-01,-1.98868186450327167e-01,

8,15
1.09924352649113999e+00,1.05626940224280785e+00,1.71052003104654286e-02,2.12762921959618843e-02,2.69684789332957676e-02,1.10652872033099392e+00,1.35804569998792743e-02,1.30574009323507819e-02,1.69954818286400730e-02,4.29167178077525802e-01,4.29832041624811700e-01,4.40926660387128466e-01,1.17962830630400197e-03,3.18728772903320795e-03,8.48362752184181682e-03,
1.18000428130536328e+00,1.05704842686969602e+00,2.17373907084616527e-02,2.31385978247824198e-02,2.68669382717110702e-02,1.18303827458496702e+00,1.60903638484910690e-02,1.87899566364864816e-02,1.94918081562238804e-02,3.66911351896084814e-02,4.59843543327662752e-01,4.52096683505398833e-01,4.21334123061189336e-01,4.17815186382220708e-03,1.11071376785676669e-02,
1.21976249978474960e+00,1.05675103759426836e+00,1.93832356658702396e-02,2.46499870945266243e-02,2.66942144009854956e-02,1.22155007907149393e+00,2.76454270434553263e-02,1.31113332110565483e-02,1.72241733307544748e-02,4.53815592565854242e-01,7.65108535891092789e-02,4.76390601415813797e-01,1.85456721618843337e-03,4.70913084016548578e-01,1.33443977100431814e-02,
1.25771602602067922e+00,1.05647614865859807e+00,2.07443848108239265e-02,2.64427769137751470e-02,2.67427507250622039e-02,1.25821174251611834e+00,9.06669377123701936e-02,5.06137013241880901e-02,2.22935809253816154e-02,4.02479881527958230e-02,7.84621737833729044e-02,5.08020141164832850e-01,5.03000656838895610e-01,5.09066802573575616e-01,1.73619277948533490e-02,
1.25971641322130501e+00,1.05636266652615318e+00,1.94279464516448376e-02,2.38571367979815985e-02,3.19111302275526948e-02,1.26022729428012337e+00,5.66181512180787827e-02,4.31960935388914918e-02,3.90700259474645178e-02,4.55699500384613376e-01,4.90291881220646486e-01,1.25583308904064689e-01,2.32173196196536636e-03,6.31591997121323540e-03,4.76781230805524425e-01,
1.27859773147657396e+00,1.05602890398106330e+00,2.00959716740072430e-02,2.65573800061580309e-02,3.21162839359186714e-02,1.27832199450173500e+00,7.03551637503022675e+00,3.25286180026297667e-02,6.52292503179044836e+00,3.96291290951904795e-02,4.93316263313503756e-01,1.25153999301428009e-01,5.50433925181867512e-01,8.24329378725372278e-03,5.35124982397760518e-01,
1.28445233854298113e+00,1.05536013800391815e+00,2.32853796305150657e-02,2.56705328983992329e-02,3.06475791479639548e-02,1.28442796459558561e+00,7.02493517801889844e-02,5.47493177371692785e-01,1.21536755302589033e-01,4.88740219989978408e-01,7.88482257705450246e-02,1.26731979601059475e-01,3.65605493787362137e-03,5.34323495119442105e-01,5.73012137536775823e-01,
1.29051155721184152e+00,1.05461385398615648e+00,1.99360880955074121e-02,2.44768284442237471e-02,3.15879238191183465e-02,1.28968071814240592e+00,7.71274315619852935e+00,1.40215344940646851e+01,2.70664413854203438e+01,4.20937042650272875e-02,8.14516388423475457e-02,1.27559442431729675e-01,5.87020571782215894e-01,5.81575755398263228e-01,6.12275928220726740e-01,

