1
1
15
0
(8 0
((0,0,0) (7,7,7) (0,0,0))
((8,0,0) (15,7,7) (0,0,0))
((0,8,0) (7,15,7) (0,0,0))
((8,8,0) (15,15,7) (0,0,0))
((0,0,8) (7,7,15) (0,0,0))
((8,0,8) (15,7,15) (0,0,0))
((0,8,8) (7,15,15) (0,0,0))
((8,8,8) (15,15,15) (0,0,0))
)
8
FabOnDisk: Cell_D_00000 0
FabOnDisk: Cell_D_00000 61527
FabOnDisk: Cell_D_00000 123055
FabOnDisk: Cell_D_00000 184583
FabOnDisk: Cell_D_00000 246112
FabOnDisk: Cell_D_00000 307640
FabOnDisk: Cell_D_00000 369169
FabOnDisk: Cell_D_00000 430698

8,15
1.20419181802925452e-02,7.81652890718358313e-03,-1.45983415013733586e-02,-9.55307212723272708e-03,-6.62191197455776377e-03,6.32953511865410379e-01,-1.77947462746432471e-03,-1.14969438643277543e-02,-2.08853988274820129e-02,-1.02434524220183319e-02,-2.80209999744821144e-02,-7.16732568178706786e-02,-4.32856190465828183e-01,-4.45062920296859454e-01,-5.08300724355050249e-01,
1.18429584806146512e-02,3.21417481194712388e-03,-7.95544342699403342e-03,-1.04964946930877906e-02,-4.93433869062385143e-03,6.30579400441924509e-01,-1.26761843638371445e-02,-1.62918148580423611e-02,-2.97365330713366439e-02,-4.10829708150923623e-01,-3.48864951283242714e-02,-8.81041034402853529e-02,-5.79505916244907326e-02,-4.89585349967838646e-01,-5.24750176518628653e-01,
1.19169663880616637e-02,1.84861727728918325e-03,-1.31898944554766154e-02,-4.98750821364554904e-03,-4.86748405484237721e-03,6.28876657205292289e-01,-2.03481538757222186e-03,-4.86758680429123011e-03,-2.57866951133670849e-02,-1.50356520597632222e-02,-4.37681265488964633e-01,-1.03376087711330403e-01,-5.09976381106792553e-01,-1.21023848273515949e-01,-5.29938850057118715e-01,
1.18911476647503254e-02,5.44168232189422025e-04,-1.23976178296801159e-02,-6.73302825031359044e-03,-6.20031142233414337e-03,6.28730116379889070e-01,-5.53016478903296110e-02,-2.16574442296457101e-02,-7.83337235539496024e-02,-4.59234471156164947e-01,-4.45583540715497883e-01,-1.26012410084909321e-01,-5.93516122072260469e-02,-1.22488715214377902e-01,-5.92759292632480617e-01,
1.19693243026855710e-02,5.43855487175721954e-04,-1.19126772905990223e-02,-7.38675481341102835e-03,-2.53392681815792220e-03,6.29170532696122331e-01,-1.47776446777624117e-02,-3.17802687395457029e-02,-2.65202660404709103e-03,-1.84426320082137774e-02,-5.08028010371325833e-02,-4.49510457593717050e-01,-5.39743375379153068e-01,-5.75450777137757497e-01,-1.94480559938705749e-01,
1.19609854043708080e-02,-2.68410517835506422e-04,-1.22196343101516423e-02,-1.27837315709480003e-02,-2.45770571573063288e-03,6.28346700750795017e-01,-1.38261295694118557e-02,-4.02319404074109155e-01,-3.17855315960471462e-03,-4.76130240430433060e-01,-6.26962403880879926e-02,-4.78536389861800970e-01,-5.91993144528918380e-02,-6.02721060431567923e-01,-1.94908378472162191e-01,
1.20474088543117818e-02,-3.80414035112110140e-04,-1.18015661860283172e-02,-9.20586094577245141e-03,-2.96570573349667476e-03,6.29076875107898892e-01,-2.78028363809375359e-02,-1.42185807704877012e-02,-2.32271606925577578e-02,-2.67785854574861051e-02,-4.63762527776393318e-01,-4.95222379265449764e-01,-5.68942279924042116e-01,-1.25526890651812550e-01,-2.01575859904995158e-01,
1.20824581556747343e-02,-8.27358469130703186e-04,-1.67983530729692576e-02,-1.43431980346429792e-02,-5.03396236699432675e-03,6.27964907404656381e-01,-2.66622860018062013e-02,-1.67633113079317109e-02,-2.04397455605335940e-02,-4.80801092115074935e-01,-4.98482792646155304e-01,-5.06905925617091135e-01,-6.42633626281887416e-02,-1.27207766638404995e-01,-2.02325325075246504e-01,

8,15
1.09236386835696120e+00,1.05636321691601776e+00,1.70699892467769711e-02,2.14672794028498114e-02,2.69994590628313200e-02,1.10018039726414485e+00,1.36384510135720109e-02,1.29227273459175049e-02,1.71131201508384206e-02,4.27513927302658692e-01,4.27239945492019935e-01,4.43042152429924729e-01,1.15805607486874898e-03,3.21747851112658698e-03,8.80375304725689034e-03,
1.17520268436767195e+00,1.05713740344708840e+00,2.17127706156047193e-02,2.29732721863268249e-02,2.69085099132435439e-02,1.17841685917961914e+00,1.48490116616832799e-02,1.81811047258992574e-02,1.97340863416070218e-02,3.66798451228897426e-02,4.58186938146977529e-01,4.48662244492758711e-01,4.20294289467656679e-01,4.21034931934255452e-03,1.15203918033080326e-02,
1.21755784403303946e+00,1.05676875098294287e+00,1.94145831608498742e-02,2.47422611757925175e-02,2.67393735202549332e-02,1.21940646131032859e+00,2.65018280376626662e-02,1.26097579242219378e-02,1.73920040674510647e-02,4.53531348469088158e-01,7.79265144179984437e-02,4.74360094895441009e-01,1.82744514448704974e-03,4.69180913745017136e-01,1.40694404380658049e-02,
1.25648888956730409e+00,1.05651351817856010e+00,2.08583564118241041e-02,2.65491055647889343e-02,2.70170728323733400e-02,1.25703305779949348e+00,8.35186064205809264e-02,4.74259340531240081e-02,2.23855957008637779e-02,3.97665918412263841e-02,7.93291725779127765e-02,5.06851068696668849e-01,5.00522536364783499e-01,5.07304757622014990e-01,1.82957624716036903e-02,
1.25879257410108769e+00,1.05624237215545858e+00,1.95346383475855229e-02,2.37827763449455949e-02,3.19194935592935630e-02,1.25933642958826342e+00,5.88133633995678792e-02,4.39893981353464483e-02,3.91248084421325359e-02,4.55515056068219348e-01,4.91136615285480027e-01,1.27541958723280557e-01,2.29569596754366318e-03,6.47031364965290363e-03,4.77079993078549203e-01,
1.27764912244111750e+00,1.05593204006961616e+00,2.02049235935049601e-02,2.65487293754130722e-02,3.21902781051221290e-02,1.27738071192328206e+00,3.35909602731993773e-01,3.07934041693852315e-02,1.66578574114992106e-01,3.94390448825603646e-02,4.95097098213599041e-01,1.26800718457126760e-01,5.49160882111685233e-01,8.42780315269467742e-03,5.35298317630465537e-01,
1.28493625197179884e+00,1.05526843216905331e+00,2.32113644007404876e-02,2.58192834681639505e-02,3.07282016531786814e-02,1.28459286404275619e+00,7.04762263188865035e-02,5.13191211070556444e-02,5.33037213278831842e-02,4.88979060290257839e-01,8.09271637324349979e-02,1.29207544452910605e-01,3.63348887711027139e-03,5.32410787849875500e-01,5.74858086608048602e-01,
1.29032174267389088e+00,1.05454077127040136e+00,1.99647310028629940e-02,2.47332832879909419e-02,3.16476056082263951e-02,1.28957034927058412e+00,7.03555207380320735e-01,9.81357197525245528e-01,5.03231552984248709e-01,4.14227039504464906e-02,8.28851194001173353e-02,1.29501106542142197e-01,5.87470114483741757e-01,5.83263787206985129e-01,6.11785382853157200e-01,

