1
1
15
0
(8 0
((0,0,0) (7,7,7) (0,0,0))
((8,0,0) (15,7,7) (0,0,0))
((0,8,0) (7,15,7) (0,0,0))
((8,8,0) (15,15,7) (0,0,0))
((0,0,8) (7,7,15) (0,0,0))
((8,0,8) (15,7,15) (0,0,0))
((0,8,8) (7,15,15) (0,0,0))
((8,8,8) (15,15,15) (0,0,0))
)
8
FabOnDisk: Cell_D_00000 0
FabOnDisk: Cell_D_00000 61527
FabOnDisk: Cell_D_00000 123055
FabOnDisk: Cell_D_00000 184583
FabOnDisk: Cell_D_00000 246112
FabOnDisk: Cell_D_00000 307640
FabOnDisk: Cell_D_00000 369169
FabOnDisk: Cell_D_00000 430698

8,15
1.2041918180292545e-02,7.8165289071835831e-03,-1.4598341501373359e-02,-9.5530721272327271e-03,-6.6219119745577638e-03,6.3295351186541038e-01,-1.7794746274643247e-03,-1.1496943864327754e-02,-2.0885398827482013e-02,-1.0243452422018332e-02,-2.8020999974482114e-02,-7.1673256817870679e-02,-4.3285619046582818e-01,-4.4506292029685945e-01,-5.0830072435505025e-01,
1.1842958480614651e-02,3.2141748119471239e-03,-7.9554434269940334e-03,-1.0496494693087791e-02,-4.9343386906238514e-03,6.3057940044192451e-01,-1.2676184363837145e-02,-1.6291814858042361e-02,-2.9736533071336644e-02,-4.1082970815092362e-01,-3.4886495128324271e-02,-8.8104103440285353e-02,-5.7950591624490733e-02,-4.8958534996783865e-01,-5.2475017651862865e-01,
1.1916966388061664e-02,1.8486172772891832e-03,-1.3189894455476615e-02,-4.9875082136455490e-03,-4.8674840548423772e-03,6.2887665720529229e-01,-2.0348153875722219e-03,-4.8675868042912301e-03,-2.5786695113367085e-02,-1.5035652059763222e-02,-4.3768126548896463e-01,-1.0337608771133040e-01,-5.0997638110679255e-01,-1.2102384827351595e-01,-5.2993885005711872e-01,
1.1891147664750325e-02,5.4416823218942202e-04,-1.2397617829680116e-02,-6.7330282503135904e-03,-6.2003114223341434e-03,6.2873011637988907e-01,-5.5301647890329611e-02,-2.1657444229645710e-02,-7.8333723553949602e-02,-4.5923447115616495e-01,-4.4558354071549788e-01,-1.2601241008490932e-01,-5.9351612207226047e-02,-1.2248871521437790e-01,-5.9275929263248062e-01,
1.1969324302685571e-02,5.4385548717572195e-04,-1.1912677290599022e-02,-7.3867548134110284e-03,-2.5339268181579222e-03,6.2917053269612233e-01,-1.4777644677762412e-02,-3.1780268739545703e-02,-2.6520266040470910e-03,-1.8442632008213777e-02,-5.0802801037132583e-02,-4.4951045759371705e-01,-5.3974337537915307e-01,-5.7545077713775750e-01,-1.9448055993870575e-01,
1.1960985404370808e-02,-2.6841051783550642e-04,-1.2219634310151642e-02,-1.2783731570948000e-02,-2.4577057157306329e-03,6.2834670075079502e-01,-1.3826129569411856e-02,-4.0231940407410915e-01,-3.1785531596047146e-03,-4.7613024043043306e-01,-6.2696240388087993e-02,-4.7853638986180097e-01,-5.9199314452891838e-02,-6.0272106043156792e-01,-1.9490837847216219e-01,
1.2047408854311782e-02,-3.8041403511211014e-04,-1.1801566186028317e-02,-9.2058609457724514e-03,-2.9657057334966748e-03,6.2907687510789889e-01,-2.7802836380937536e-02,-1.4218580770487701e-02,-2.3227160692557758e-02,-2.6778585457486105e-02,-4.6376252777639332e-01,-4.9522237926544976e-01,-5.6894227992404212e-01,-1.2552689065181255e-01,-2.0157585990499516e-01,
1.2082458155674734e-02,-8.2735846913070319e-04,-1.6798353072969258e-02,-1.4343198034642979e-02,-5.0339623669943268e-03,6.2796490740465638e-01,-2.6662286001806201e-02,-1.6763311307931711e-02,-2.0439745560533594e-02,-4.8080109211507494e-01,-4.9848279264615530e-01,-5.0690592561709114e-01,-6.4263362628188742e-02,-1.2720776663840500e-01,-2.0232532507524650e-01,

8,15
1.0923638683569612e+00,1.0563632169160178e+00,1.7069989246776971e-02,2.1467279402849811e-02,2.6999459062831320e-02,1.1001803972641448e+00,1.3638451013572011e-02,1.2922727345917505e-02,1.7113120150838421e-02,4.2751392730265869e-01,4.2723994549201993e-01,4.4304215242992473e-01,1.1580560748687490e-03,3.2174785111265870e-03,8.8037530472568903e-03,
1.1752026843676719e+00,1.0571374034470884e+00,2.1712770615604719e-02,2.2973272186326825e-02,2.6908509913243544e-02,1.1784168591796191e+00,1.4849011661683280e-02,1.8181104725899257e-02,1.9734086341607022e-02,3.6679845122889743e-02,4.5818693814697753e-01,4.4866224449275871e-01,4.2029428946765668e-01,4.2103493193425545e-03,1.1520391803308033e-02,
1.2175578440330395e+00,1.0567687509829429e+00,1.9414583160849874e-02,2.4742261175792517e-02,2.6739373520254933e-02,1.2194064613103286e+00,2.6501828037662666e-02,1.2609757924221938e-02,1.7392004067451065e-02,4.5353134846908816e-01,7.7926514417998444e-02,4.7436009489544101e-01,1.8274451444870497e-03,4.6918091374501714e-01,1.4069440438065805e-02,
1.2564888895673041e+00,1.0565135181785601e+00,2.0858356411824104e-02,2.6549105564788934e-02,2.7017072832373340e-02,1.2570330577994935e+00,8.3518606420580926e-02,4.7425934053124008e-02,2.2385595700863778e-02,3.9766591841226384e-02,7.9329172577912777e-02,5.0685106869666885e-01,5.0052253636478350e-01,5.0730475762201499e-01,1.8295762471603690e-02,
1.2587925741010877e+00,1.0562423721554586e+00,1.9534638347585523e-02,2.3782776344945595e-02,3.1919493559293563e-02,1.2593364295882634e+00,5.8813363399567879e-02,4.3989398135346448e-02,3.9124808442132536e-02,4.5551505606821935e-01,4.9113661528548003e-01,1.2754195872328056e-01,2.2956959675436632e-03,6.4703136496529036e-03,4.7707999307854920e-01,
1.2776491224411175e+00,1.0559320400696162e+00,2.0204923593504960e-02,2.6548729375413072e-02,3.2190278105122129e-02,1.2773807119232821e+00,3.3590960273199377e-01,3.0793404169385231e-02,1.6657857411499211e-01,3.9439044882560365e-02,4.9509709821359904e-01,1.2680071845712676e-01,5.4916088211168523e-01,8.4278031526946774e-03,5.3529831763046554e-01,
1.2849362519717988e+00,1.0552684321690533e+00,2.3211364400740488e-02,2.5819283468163950e-02,3.0728201653178681e-02,1.2845928640427562e+00,7.0476226318886503e-02,5.1319121107055644e-02,5.3303721327883184e-02,4.8897906029025784e-01,8.0927163732434998e-02,1.2920754445291061e-01,3.6334888771102714e-03,5.3241078784987550e-01,5.7485808660804860e-01,
1.2903217426738909e+00,1.0545407712704014e+00,1.9964731002862994e-02,2.4733283287990942e-02,3.1647605608226395e-02,1.2895703492705841e+00,7.0355520738032074e-01,9.8135719752524553e-01,5.0323155298424871e-01,4.1422703950446491e-02,8.2885119400117335e-02,1.2950110654214220e-01,5.8747011448374176e-01,5.8326378720698513e-01,6.1178538285315720e-01,

