1
1
15
0
(8 0
((0,0,0) (7,7,7) (0,0,0))
((8,0,0) (15,7,7) (0,0,0))
((0,8,0) (7,15,7) (0,0,0))
((8,8,0) (15,15,7) (0,0,0))
((0,0,8) (7,7,15) (0,0,0))
((8,0,8) (15,7,15) (0,0,0))
((0,8,8) (7,15,15) (0,0,0))
((8,8,8) (15,15,15) (0,0,0))
)
8
FabOnDisk: Cell_D_00000 0
FabOnDisk: Cell_D_00000 61527
FabOnDisk: Cell_D_00000 123055
FabOnDisk: Cell_D_00000 184583
FabOnDisk: Cell_D_00000 246112
FabOnDisk: Cell_D_00000 307640
FabOnDisk: Cell_D_00000 369169
FabOnDisk: Cell_D_00000 430698

8,15
1.23855595109162771e-02,5.96408375337908539e-02,-1.57865432353529664e-02,-1.55523329244310893e-02,-1.29928643461530643e-02,6.33890781119067048e-01,-2.81260221721070427e-03,-2.23911138347181356e-03,-8.73552167655559670e-04,-9.57062784895122177e-03,-3.97018926592281468e-02,-1.27617398076436822e-01,-3.46011079851249459e-01,-3.89814192652559899e-01,-4.40839161148423475e-01,
1.21556949114255287e-02,2.59415503906317117e-02,-1.00954317439060567e-02,-1.57723261846650017e-02,-1.24485794515675798e-02,6.35127335852025632e-01,-7.84688130508921951e-03,-1.97937374241754496e-03,-1.54435492220452580e-03,-3.59695058043154714e-01,-5.25371012088738931e-02,-1.63319831860019610e-01,-8.94547960112111601e-02,-4.49148900940846307e-01,-4.96505101605206889e-01,
1.21572384548507949e-02,8.25388942529309798e-03,-1.36239335518569659e-02,-1.07225847196719248e-02,-1.17343117606004983e-02,6.28201722780648897e-01,-2.40984623449877174e-03,-1.07379019067539855e-02,-2.58329341910107438e-02,-1.71929968377541216e-02,-3.97578131472249297e-01,-2.09265228929050584e-01,-4.27696610012449574e-01,-1.82816153762937944e-01,-5.64437832196402312e-01,
1.21899151782533400e-02,2.74222728959649595e-03,-1.60486841072081908e-02,-1.47859524393819976e-02,-1.34647854597008589e-02,6.28066228397333726e-01,-1.46555086274645589e-02,-1.23176578937604555e-02,-4.79448322726615528e-02,-4.30138007977409309e-01,-4.04275910822345930e-01,-2.60319876902352754e-01,-8.96830099710322903e-02,-1.84990838940355340e-01,-6.01711490873033883e-01,
1.21898988849375930e-02,2.10664730927238864e-03,-1.42068539218774478e-02,-1.56842031843024005e-02,-1.26332678011396877e-02,6.28362620163781305e-01,-2.98939300946063271e-03,-2.95816722485188997e-02,-6.21361075411375023e-03,-2.36754406864538094e-02,-9.63093985506128930e-02,-4.37072829832048093e-01,-5.12273709005890421e-01,-5.16406807347879693e-01,-2.81116017851890387e-01,
1.22198864504866420e-02,4.14910124213129796e-04,-1.45209957753740758e-02,-1.48140090513816415e-02,-1.18902388138878885e-02,6.29107683283956609e-01,-7.78395034545143472e-02,-1.25337235817888359e-01,-2.24122657964171898e-02,-4.59659716938734753e-01,-1.24886763585913024e-01,-4.50181076624837417e-01,-9.04579817336807201e-02,-5.94760282785738781e-01,-2.85461485255615210e-01,
1.23192930495260710e-02,-4.35646821042557763e-04,-1.47659848054582186e-02,-1.14732791170855941e-02,-1.09644467796443396e-02,6.28878891581977184e-01,-5.25962757563640304e-01,-1.92205068454475825e-01,-2.58016243926310396e-01,-4.14206380491502490e-02,-4.86185056025522644e-01,-4.49795466929109544e-01,-5.79615508202516949e-01,-1.89607374378432392e-01,-2.84610004250627546e-01,
1.24190063048488161e-02,-8.03824401458288129e-04,-1.70173402379437851e-02,-1.22777589095831134e-02,-1.45713013279522453e-02,6.28975677184780868e-01,-1.01317502142968641e+00,-2.30968018263053437e-02,-1.80623728890061930e+00,-4.75050152940228065e-01,-5.04512674298794650e-01,-4.94612992330144219e-01,-9.18544811187597815e-02,-1.91625410547773045e-01,-2.85479102345779778e-01,

8,15
7.75098712248528554e-01,1.05502170677371954e+00,1.28403733636739958e-02,1.55846682556645792e-02,1.62346554764479303e-02,1.06740726628463589e+00,9.37102433404749489e-03,1.12843865604054343e-02,9.30856381234032929e-03,3.67441881323936959e-01,4.04493877683669123e-01,4.21615584930844556e-01,1.06154294292086634e-03,4.57252975659939304e-03,1.93660073939118799e-02,
9.34203968421528086e-01,1.05604160131281866e+00,1.86369846859224357e-02,1.81883878776059986e-02,2.00126601265323834e-02,1.06819756043251202e+00,4.99853463748529785e-03,1.46678755567511299e-02,9.68686845356129221e-03,5.72424841484346705e-02,4.27278584248354965e-01,4.60324393350894590e-01,3.42421942459151030e-01,6.41949765595273281e-03,2.77555617205828623e-02,
1.08474204622740245e+00,1.05603391383352463e+00,1.84073922108204634e-02,1.99070304222459249e-02,1.76579388160785292e-02,1.09299593565269548e+00,1.66839254999645512e-02,1.12746859261426170e-02,1.30739219409968695e-02,4.25964591366364831e-01,1.18764354539407507e-01,4.87183849384724366e-01,2.03365951911626533e-03,3.97583348065669695e-01,4.02328019200217657e-02,
1.18756046253903436e+00,1.05564221757260834e+00,1.67694443574821703e-02,2.01950921228882599e-02,2.06848926106610112e-02,1.19030268982863086e+00,2.00110464560663559e-02,1.19636616826782477e-02,1.31534497657092679e-02,5.80430396753510228e-02,1.19832557517185426e-01,4.93746672303258249e-01,4.37602018673616977e-01,4.43180880839228131e-01,5.71265591788178151e-02,
1.20790576030410146e+00,1.05576764959337965e+00,1.74106190528655370e-02,1.57289127001371334e-02,2.11332003592726927e-02,1.21001240761337381e+00,1.90924458567789737e-02,1.30196605422332121e-02,1.14399486111280840e-02,4.62991585025348762e-01,4.65857316728061410e-01,1.80373882017942633e-01,2.87182616606866670e-03,1.30986614961602493e-02,4.61218448369470679e-01,
1.25945865813857094e+00,1.05536069600030524e+00,1.70426351928188585e-02,1.63555278735116119e-02,2.04546056665284373e-02,1.25987356826278396e+00,9.31117720741600485e-02,1.23159669677969409e-02,4.57060205530914268e-02,5.83666209354562482e-02,5.05368852741798880e-01,1.80373602691299817e-01,5.15661947491653394e-01,1.84735429623640417e-02,5.12968367514577750e-01,
1.28211544232778518e+00,1.05446272349180248e+00,1.88955797848540177e-02,2.03668080409483213e-02,2.07779720196845444e-02,1.28167979550674271e+00,5.42165612777023853e-02,4.05063093844349603e-02,6.75836094655698494e-01,4.75906110343750743e-01,1.21085025470743457e-01,1.80795228620571680e-01,5.59387987369347299e-03,5.55234225348264165e-01,5.40162257465757634e-01,
1.29136773680066241e+00,1.05288052052441983e+00,1.81904453803676501e-02,1.95580838586861885e-02,2.10454830868632807e-02,1.29056391239920409e+00,1.02722210065427005e-01,7.82582810441855847e-01,1.34832692859854830e-01,5.88045485173663632e-02,1.21952400116679252e-01,1.81958890237240434e-01,5.62700665573721337e-01,6.08421443335359191e-01,5.75825117962900701e-01,

