1
1
15
0
(8 0
((0,0,0) (7,7,7) (0,0,0))
((8,0,0) (15,7,7) (0,0,0))
((0,8,0) (7,15,7) (0,0,0))
((8,8,0) (15,15,7) (0,0,0))
((0,0,8) (7,7,15) (0,0,0))
((8,0,8) (15,7,15) (0,0,0))
((0,8,8) (7,15,15) (0,0,0))
((8,8,8) (15,15,15) (0,0,0))
)
8
FabOnDisk: Cell_D_00000 0
FabOnDisk: Cell_D_00000 61527
FabOnDisk: Cell_D_00000 123055
FabOnDisk: Cell_D_00000 184583
FabOnDisk: Cell_D_00000 246112
FabOnDisk: Cell_D_00000 307640
FabOnDisk: Cell_D_00000 369169
FabOnDisk: Cell_D_00000 430698

8,15
1.2308649764816194e-02,3.2843899078205389e-02,-1.3385610077232955e-02,-1.4008536479357759e-02,-7.9461674603821687e-03,6.2747228229515006e-01,-2.0423894409421673e-03,-3.7201692652099515e-04,8.6461450371020168e-04,-9.8634627561851769e-03,-3.4259782921466919e-02,-1.1195195272513969e-01,-3.7195999562726589e-01,-4.2203231511989481e-01,-4.6825373773736062e-01,
1.2091367419648778e-02,1.3608159814563925e-02,-9.6090786318711215e-03,-1.3827208051810157e-02,-7.7294484417866731e-03,6.2786400510595741e-01,-1.0010594443569760e-02,-2.9781223449432153e-04,-1.2337092510458457e-03,-3.6808151686830104e-01,-4.4044105862093133e-02,-1.4042029064977604e-01,-7.5689523705219766e-02,-4.6423820664657367e-01,-5.2603234393351939e-01,
1.2111060355252477e-02,4.9468995036361391e-03,-1.4095909488878252e-02,-8.3737713421468546e-03,-7.7510049812404801e-03,6.2823743097889473e-01,-1.6815587838897642e-03,-8.1178967654935499e-03,-3.7685438650232383e-02,-1.6476307987835743e-02,-4.1171801375949157e-01,-1.7541222450503402e-01,-4.5980008189085175e-01,-1.6238560237990574e-01,-5.6787735814098417e-01,
1.2135444903843821e-02,1.9173725623736473e-03,-1.3378398635865027e-02,-1.1232975206527347e-02,-1.1200591226664953e-02,6.2805940750629374e-01,-1.8776226275490242e-02,-7.8555480540821350e-03,-4.3294119739948414e-02,-4.3942506206345089e-01,-4.2025125987762452e-01,-2.1588555291975770e-01,-8.0020690904631889e-02,-1.6317910733152827e-01,-5.8419866498441975e-01,
1.2175061595854735e-02,1.4794144650998179e-03,-1.2745184723393851e-02,-1.3051786703556740e-02,-7.2205738842865252e-03,6.2941210280781246e-01,-2.6132134998343519e-03,-2.3885646541205771e-02,-8.8745379847243178e-03,-2.1989165790045596e-02,-7.5930974210562774e-02,-4.4784943954206313e-01,-5.2660613612594576e-01,-5.4315042701404115e-01,-2.5925636846120503e-01,
1.2203997190444404e-02,9.3101093455600059e-05,-1.4051852924953097e-02,-1.2329098094223690e-02,-8.6860517884318356e-03,6.2896925746664634e-01,-1.6688414033952995e-01,-5.7385462486133709e-01,-7.7782157888445946e-02,-4.6492563796942066e-01,-9.6503658004408438e-02,-4.6508176868748713e-01,-7.9107315935253802e-02,-6.0313259637193728e-01,-2.6027446705345980e-01,
1.2286242476841888e-02,-4.2356245891842582e-04,-1.2744489338678867e-02,-9.2227179131140549e-03,-7.8534538623630003e-03,6.2843055244979840e-01,-2.8919716300358826e-02,-1.7507525595173830e-02,-1.1714521197286953e-02,-3.5991358253038598e-02,-4.8098717568942639e-01,-4.6826819692666072e-01,-5.6800882865627744e-01,-1.6666916694063705e-01,-2.6121009945909857e-01,
1.2353549731752046e-02,-7.5718458149043539e-04,-1.4919993432263422e-02,-1.2974578381834573e-02,-1.0505955036506876e-02,6.2757542576097425e-01,-2.3710478697637477e-01,-1.8526167126888957e-02,-3.0489795629987989e-02,-4.7043242698365184e-01,-5.0797152918531241e-01,-4.7176556821880400e-01,-8.2548596678764324e-02,-1.6792259774483598e-01,-2.6276619045978966e-01,

8,15
8.9181704115943938e-01,1.0553773665530353e+00,1.4555647129984679e-02,1.7040112273797110e-02,2.0541358770683735e-02,1.0676906138018551e+00,1.2722526394343067e-02,1.3132307346203229e-02,9.9979539190886094e-03,3.7097296812090980e-01,4.1244525111258518e-01,4.4695934917596469e-01,1.0953167363787126e-03,3.9114629249898704e-03,1.5741848925086638e-02,
1.0260300950299586e+00,1.0563032559301930e+00,1.8040562938859216e-02,1.9901187900098365e-02,2.2630454735961869e-02,1.0684100840579041e+00,6.0915985151111917e-03,1.3697808640770717e-02,1.2347281129998361e-02,5.0627369928203388e-02,4.1951984284864269e-01,4.7065395776996688e-01,3.7194961848041341e-01,5.2995764925113141e-03,2.1673692144765905e-02,
1.1369602726387396e+00,1.0562166298939437e+00,1.7852151908411364e-02,2.3625643462406327e-02,2.1319963790585802e-02,1.1419071721423757e+00,1.6073541503011757e-02,7.6988197169514687e-03,1.4568520173989078e-02,4.4110320795103869e-01,1.0388020485988742e-01,4.8012086284611410e-01,1.9620087050014707e-03,4.2018316619555518e-01,2.9789876598896415e-02,
1.2142884705345840e+00,1.0558509312131505e+00,1.9145515065341057e-02,2.3675868268564371e-02,2.4060977298372133e-02,1.2162058430969576e+00,2.5211062099419042e-02,9.0534082010275581e-03,1.6416292358139704e-02,5.1862659442446564e-02,1.0459938020229165e-01,4.7987016885403255e-01,4.5714803498445772e-01,4.6366961717538779e-01,4.0769909575941982e-02,
1.2291500584771595e+00,1.0557832427920681e+00,1.8532694505111171e-02,1.7827312898256911e-02,2.3669119899969285e-02,1.2306294729422593e+00,3.4715599824792179e-02,1.5435586224685690e-02,2.4507602635326649e-02,4.6447796448440715e-01,4.8161911240774957e-01,1.6553545174346640e-01,2.6764891913476432e-03,9.8984200282387948e-03,4.7676427268066629e-01,
1.2670464861936459e+00,1.0553927394251321e+00,1.8414875324392514e-02,1.9975697196252279e-02,2.3742849866029619e-02,1.2671530174994403e+00,3.8431251774276343e-01,1.6957951988043236e-02,3.6928855657864124e-01,5.1915722589645164e-02,5.0800129346668854e-01,1.6585001832876256e-01,5.2650556905599011e-01,1.3436156422801708e-02,5.2825826447912827e-01,
1.2828505319619157e+00,1.0546077641932348e+00,1.9128554707217540e-02,2.3303839472798876e-02,2.3637169912179422e-02,1.2824741320896884e+00,6.2628301401949721e-02,1.0903616772419975e-01,2.4075674170500538e-01,4.6912807026616399e-01,1.0641104960270799e-01,1.6712173649981735e-01,4.8423970752027885e-03,5.4274342920737806e-01,5.6170035809692154e-01,
1.2912507758902079e+00,1.0534310089101759e+00,1.7225504979250524e-02,2.2771429275524051e-02,2.3406650673914717e-02,1.2905647111292300e+00,9.2126686541507530e-01,1.6351398317920336e+00,5.4618089728383867e-01,5.3255708425656523e-02,1.0749843839210849e-01,1.6776106142633046e-01,5.7093553683155407e-01,6.0348173060549115e-01,5.6716774013021176e-01,

