1
1
15
0
(8 0
((0,0,0) (7,7,7) (0,0,0))
((8,0,0) (15,7,7) (0,0,0))
((0,8,0) (7,15,7) (0,0,0))
((8,8,0) (15,15,7) (0,0,0))
((0,0,8) (7,7,15) (0,0,0))
((8,0,8) (15,7,15) (0,0,0))
((0,8,8) (7,15,15) (0,0,0))
((8,8,8) (15,15,15) (0,0,0))
)
8
FabOnDisk: Cell_D_00000 0
FabOnDisk: Cell_D_00000 61527
FabOnDisk: Cell_D_00000 123055
FabOnDisk: Cell_D_00000 184583
FabOnDisk: Cell_D_00000 246112
FabOnDisk: Cell_D_00000 307640
FabOnDisk: Cell_D_00000 369169
FabOnDisk: Cell_D_00000 430698

8,15
1.23096519920378195e-02,3.05234101766790125e-02,-1.30024228974433814e-02,-1.39964306511644355e-02,-7.86322103011628457e-03,6.27569494110694737e-01,-2.00690195674632036e-03,-3.95411307101861437e-04,7.49596334001068174e-04,-1.01417611706776101e-02,-3.37823934713580853e-02,-1.08884379305617479e-01,-3.75126479619493414e-01,-4.24544669434212207e-01,-4.72133963349275654e-01,
1.20923392500040579e-02,1.24512754297414104e-02,-9.78047603891018733e-03,-1.38077195382706516e-02,-7.71286401350875731e-03,6.27812630262317262e-01,-9.98434349335142191e-03,-1.78946779707389613e-04,-3.55484577018535131e-03,-3.71161988684314492e-01,-4.35277009033373311e-02,-1.36875905495660088e-01,-7.63116490903890804e-02,-4.65000194244396703e-01,-5.28289226773455245e-01,
1.21096655192121632e-02,4.66880325077371951e-03,-1.41166299766885585e-02,-8.49854126116389441e-03,-8.04032998188862306e-03,6.28229012420721711e-01,-1.64436913668208375e-03,-7.88151970237680605e-03,-3.88071100743189040e-02,-1.68111805928827414e-02,-4.13241140129191886e-01,-1.69710241815953788e-01,-4.63360779489907337e-01,-1.59983478010895991e-01,-5.66560598669978321e-01,
1.21352370754244168e-02,1.80409330835547342e-03,-1.30846258119305427e-02,-1.08026573488347218e-02,-1.09931517342154277e-02,6.28050893130146282e-01,-1.96846641581530576e-02,-7.63177861561680805e-03,-4.25213365064699977e-02,-4.41238667715890931e-01,-4.21856869837941018e-01,-2.09497842747258384e-01,-8.04567764935689989e-02,-1.60879294037715170e-01,-5.80361392290879241e-01,
1.21734833130511082e-02,1.47508075493737816e-03,-1.27984222047261634e-02,-1.29214032316312833e-02,-6.99497151923767543e-03,6.29288557565411133e-01,-2.51484126275589590e-03,-2.34946471307719354e-02,-8.37378970721812561e-03,-2.22232933678346636e-02,-7.36001297056300408e-02,-4.48470444547975688e-01,-5.27575570415104389e-01,-5.44294579512821342e-01,-2.55587727463083336e-01,
1.22026087642008486e-02,1.32378542753507880e-04,-1.36934785358103998e-02,-1.22192392989156472e-02,-8.17302514405254463e-03,6.28981284958777254e-01,-1.01906493238527407e-01,-4.25256922823951999e-01,-1.94974724861063514e-02,-4.65130634741806714e-01,-9.37151370209231699e-02,-4.66838139283083209e-01,-7.94134772030078429e-02,-6.03165855139934926e-01,-2.56224210328600877e-01,
1.22789872808821317e-02,-4.13441686132286798e-04,-1.25818480288102247e-02,-9.26612877033518821e-03,-7.91389453322934033e-03,6.28184819411814699e-01,-2.86794920894189662e-02,-1.69992647551982373e-02,-1.03719915386699876e-02,-3.60938827971411316e-02,-4.79201793159408806e-01,-4.70567740007757140e-01,-5.68414749428468147e-01,-1.63705920418597245e-01,-2.57104838597024377e-01,
1.23461877956722206e-02,-7.44134674740582012e-04,-1.49317659070902081e-02,-1.31292865118065351e-02,-1.03250247512227684e-02,6.27797203836726991e-01,-7.10239834159517441e-02,-1.77761669757391383e-02,-2.95607768598350057e-02,-4.70101058200273925e-01,-5.07580484687692124e-01,-4.70178550753029723e-01,-8.28858207005084974e-02,-1.65123720406285091e-01,-2.58690307484350346e-01,

8,15
9.04440231157321972e-01,1.05537244525054197e+00,1.47131077503813053e-02,1.68947080900103130e-02,2.04562446173341753e-02,1.06768805352337726e+00,1.28371188060011302e-02,1.29776732583549922e-02,9.99482368774430932e-03,3.74622933192113650e-01,4.12159498080134079e-01,4.48532190604925773e-01,1.12689231370317455e-03,3.85057573354481708e-03,1.51314422938590501e-02,
1.03729447776569339e+00,1.05630037669893184e+00,1.79573043028747985e-02,1.97400521090029812e-02,2.25328303341611504e-02,1.06840905841513334e+00,6.48144389148060107e-03,1.35182067265173442e-02,1.28770943335309324e-02,5.08029145274553479e-02,4.17441388902062172e-01,4.70492795658875251e-01,3.75068472392935615e-01,5.22656102301561828e-03,2.08559833611307241e-02,
1.14243663362760994e+00,1.05619216787885883e+00,1.75548317150820941e-02,2.36786565300998869e-02,2.12600697916949660e-02,1.14710543687838373e+00,1.59160919634382080e-02,7.64746660373413420e-03,1.45042192525524152e-02,4.42692925698102036e-01,1.02420980886928331e-01,4.77782273059977947e-01,2.00559722748048889e-03,4.22850580077884897e-01,2.82936951454978471e-02,
1.21788765169238244e+00,1.05583768005214584e+00,1.91341234078538161e-02,2.37287625391497010e-02,2.39586258082081435e-02,1.21969174500073785e+00,2.72584202799813491e-02,8.51943436103132397e-03,1.63223639217191796e-02,5.21662251649888109e-02,1.02699698110750776e-01,4.77640813181400614e-01,4.61263307671862466e-01,4.66499838754620755e-01,3.87730030131637204e-02,
1.22990593264691506e+00,1.05577844091152429e+00,1.83378104003377868e-02,1.78681701197710395e-02,2.38024080583716727e-02,1.23138101340185235e+00,3.05668929876259758e-02,1.57822939535380360e-02,2.40831311684367201e-02,4.65002274964773143e-01,4.82279797746740846e-01,1.63214956412920081e-01,2.70997742962108970e-03,9.53269151648611715e-03,4.77030082263651123e-01,
1.26683849448293828e+00,1.05541206706377855e+00,1.85270341326310636e-02,2.01961261062897947e-02,2.38782266740382720e-02,1.26697087302569189e+00,2.31268078023548318e-01,1.72840292840538909e-02,1.66698580962112070e-01,5.20734986746493947e-02,5.07697708442986118e-01,1.63611111511953539e-01,5.27680261316270327e-01,1.29601798444038060e-02,5.29706588918894994e-01,
1.28263640030093007e+00,1.05462823550976847e+00,1.89808416378624903e-02,2.34412068817439409e-02,2.33247630539446492e-02,1.28226309899371937e+00,5.95052472236126812e-02,9.18493516856032505e-02,1.69464057082868963e-01,4.69246353680185857e-01,1.04459985674338229e-01,1.64552452965457591e-01,4.85997555554544634e-03,5.39415746146691744e-01,5.63767016053559389e-01,
1.29064915471426911e+00,1.05347610801345071e+00,1.68580374172356273e-02,2.29208238913803375e-02,2.31419924130962934e-02,1.28996540707406560e+00,2.96808396068959368e-01,5.78180205414018378e-01,2.97832504357675720e-01,5.36296641175598304e-02,1.05673309973847662e-01,1.65232064746285490e-01,5.70368394665114908e-01,6.01982129029082325e-01,5.70722451842208489e-01,

