1
1
15
0
(8 0
((0,0,0) (7,7,7) (0,0,0))
((8,0,0) (15,7,7) (0,0,0))
((0,8,0) (7,15,7) (0,0,0))
((8,8,0) (15,15,7) (0,0,0))
((0,0,8) (7,7,15) (0,0,0))
((8,0,8) (15,7,15) (0,0,0))
((0,8,8) (7,15,15) (0,0,0))
((8,8,8) (15,15,15) (0,0,0))
)
8
FabOnDisk: Cell_D_00000 0
FabOnDisk: Cell_D_00000 61527
FabOnDisk: Cell_D_00000 123055
FabOnDisk: Cell_D_00000 184583
FabOnDisk: Cell_D_00000 246112
FabOnDisk: Cell_D_00000 307640
FabOnDisk: Cell_D_00000 369169
FabOnDisk: Cell_D_00000 430698

8,15
1.23086497648161944e-02,3.28438990782053894e-02,-1.33856100772329553e-02,-1.40085364793577586e-02,-7.94616746038216866e-03,6.27472282295150063e-01,-2.04238944094216725e-03,-3.72016926520995150e-04,8.64614503710201682e-04,-9.86346275618517690e-03,-3.42597829214669192e-02,-1.11951952725139692e-01,-3.71959995627265894e-01,-4.22032315119894808e-01,-4.68253737737360620e-01,
1.20913674196487780e-02,1.36081598145639249e-02,-9.60907863187112146e-03,-1.38272080518101574e-02,-7.72944844178667309e-03,6.27864005105957412e-01,-1.00105944435697602e-02,-2.97812234494321531e-04,-1.23370925104584572e-03,-3.68081516868301040e-01,-4.40441058620931331e-02,-1.40420290649776042e-01,-7.56895237052197661e-02,-4.64238206646573670e-01,-5.26032343933519386e-01,
1.21110603552524766e-02,4.94689950363613913e-03,-1.40959094888782523e-02,-8.37377134214685459e-03,-7.75100498124048007e-03,6.28237430978894729e-01,-1.68155878388976418e-03,-8.11789676549354994e-03,-3.76854386502323835e-02,-1.64763079878357428e-02,-4.11718013759491575e-01,-1.75412224505034020e-01,-4.59800081890851753e-01,-1.62385602379905736e-01,-5.67877358140984168e-01,
1.21354449038438214e-02,1.91737256237364730e-03,-1.33783986358650270e-02,-1.12329752065273465e-02,-1.12005912266649535e-02,6.28059407506293743e-01,-1.87762262754902418e-02,-7.85554805408213500e-03,-4.32941197399484140e-02,-4.39425062063450889e-01,-4.20251259877624517e-01,-2.15885552919757695e-01,-8.00206909046318887e-02,-1.63179107331528267e-01,-5.84198664984419747e-01,
1.21750615958547345e-02,1.47941446509981789e-03,-1.27451847233938514e-02,-1.30517867035567399e-02,-7.22057388428652518e-03,6.29412102807812457e-01,-2.61321349983435194e-03,-2.38856465412057711e-02,-8.87453798472431776e-03,-2.19891657900455964e-02,-7.59309742105627739e-02,-4.47849439542063132e-01,-5.26606136125945756e-01,-5.43150427014041148e-01,-2.59256368461205033e-01,
1.22039971904444045e-02,9.31010934556000585e-05,-1.40518529249530968e-02,-1.23290980942236898e-02,-8.68605178843183563e-03,6.28969257466646336e-01,-1.66884140339529946e-01,-5.73854624861337093e-01,-7.77821578884459464e-02,-4.64925637969420658e-01,-9.65036580044084380e-02,-4.65081768687487129e-01,-7.91073159352538025e-02,-6.03132596371937280e-01,-2.60274467053459801e-01,
1.22862424768418882e-02,-4.23562458918425825e-04,-1.27444893386788674e-02,-9.22271791311405492e-03,-7.85345386236300028e-03,6.28430552449798396e-01,-2.89197163003588262e-02,-1.75075255951738298e-02,-1.17145211972869527e-02,-3.59913582530385981e-02,-4.80987175689426394e-01,-4.68268196926660718e-01,-5.68008828656277442e-01,-1.66669166940637048e-01,-2.61210099459098566e-01,
1.23535497317520462e-02,-7.57184581490435386e-04,-1.49199934322634224e-02,-1.29745783818345731e-02,-1.05059550365068765e-02,6.27575425760974248e-01,-2.37104786976374771e-01,-1.85261671268889573e-02,-3.04897956299879890e-02,-4.70432426983651841e-01,-5.07971529185312409e-01,-4.71765568218803999e-01,-8.25485966787643244e-02,-1.67922597744835977e-01,-2.62766190459789661e-01,

8,15
8.91817041159439383e-01,1.05537736655303527e+00,1.45556471299846790e-02,1.70401122737971096e-02,2.05413587706837347e-02,1.06769061380185515e+00,1.27225263943430665e-02,1.31323073462032286e-02,9.99795391908860943e-03,3.70972968120909796e-01,4.12445251112585176e-01,4.46959349175964693e-01,1.09531673637871261e-03,3.91146292498987039e-03,1.57418489250866385e-02,
1.02603009502995857e+00,1.05630325593019303e+00,1.80405629388592156e-02,1.99011879000983646e-02,2.26304547359618691e-02,1.06841008405790405e+00,6.09159851511119170e-03,1.36978086407707166e-02,1.23472811299983609e-02,5.06273699282033876e-02,4.19519842848642688e-01,4.70653957769966880e-01,3.71949618480413413e-01,5.29957649251131414e-03,2.16736921447659055e-02,
1.13696027263873956e+00,1.05621662989394371e+00,1.78521519084113636e-02,2.36256434624063268e-02,2.13199637905858025e-02,1.14190717214237569e+00,1.60735415030117575e-02,7.69881971695146865e-03,1.45685201739890781e-02,4.41103207951038689e-01,1.03880204859887415e-01,4.80120862846114105e-01,1.96200870500147073e-03,4.20183166195555180e-01,2.97898765988964150e-02,
1.21428847053458400e+00,1.05585093121315055e+00,1.91455150653410573e-02,2.36758682685643713e-02,2.40609772983721333e-02,1.21620584309695756e+00,2.52110620994190418e-02,9.05340820102755808e-03,1.64162923581397044e-02,5.18626594424465640e-02,1.04599380202291647e-01,4.79870168854032553e-01,4.57148034984457718e-01,4.63669617175387794e-01,4.07699095759419816e-02,
1.22915005847715952e+00,1.05578324279206814e+00,1.85326945051111705e-02,1.78273128982569112e-02,2.36691198999692855e-02,1.23062947294225933e+00,3.47155998247921788e-02,1.54355862246856896e-02,2.45076026353266488e-02,4.64477964484407146e-01,4.81619112407749572e-01,1.65535451743466400e-01,2.67648919134764324e-03,9.89842002823879477e-03,4.76764272680666290e-01,
1.26704648619364590e+00,1.05539273942513212e+00,1.84148753243925135e-02,1.99756971962522789e-02,2.37428498660296194e-02,1.26715301749944032e+00,3.84312517742763426e-01,1.69579519880432364e-02,3.69288556578641236e-01,5.19157225896451635e-02,5.08001293466688542e-01,1.65850018328762561e-01,5.26505569055990108e-01,1.34361564228017080e-02,5.28258264479128270e-01,
1.28285053196191567e+00,1.05460776419323476e+00,1.91285547072175405e-02,2.33038394727988762e-02,2.36371699121794218e-02,1.28247413208968841e+00,6.26283014019497208e-02,1.09036167724199745e-01,2.40756741705005384e-01,4.69128070266163988e-01,1.06411049602707988e-01,1.67121736499817347e-01,4.84239707520278846e-03,5.42743429207378059e-01,5.61700358096921537e-01,
1.29125077589020787e+00,1.05343100891017594e+00,1.72255049792505235e-02,2.27714292755240508e-02,2.34066506739147168e-02,1.29056471112922999e+00,9.21266865415075298e-01,1.63513983179203359e+00,5.46180897283838673e-01,5.32557084256565227e-02,1.07498438392108486e-01,1.67761061426330460e-01,5.70935536831554069e-01,6.03481730605491151e-01,5.67167740130211762e-01,

