1
1
15
0
(8 0
((0,0,0) (7,7,7) (0,0,0))
((8,0,0) (15,7,7) (0,0,0))
((0,8,0) (7,15,7) (0,0,0))
((8,8,0) (15,15,7) (0,0,0))
((0,0,8) (7,7,15) (0,0,0))
((8,0,8) (15,7,15) (0,0,0))
((0,8,8) (7,15,15) (0,0,0))
((8,8,8) (15,15,15) (0,0,0))
)
8
FabOnDisk: Cell_D_00000 0
FabOnDisk: Cell_D_00000 61527
FabOnDisk: Cell_D_00000 123055
FabOnDisk: Cell_D_00000 184583
FabOnDisk: Cell_D_00000 246112
FabOnDisk: Cell_D_00000 307640
FabOnDisk: Cell_D_00000 369169
FabOnDisk: Cell_D_00000 430698

8,15
1.21172537127530854e-02,9.47919176935205221e-03,-1.46984032656912161e-02,-1.04487411901392959e-02,-6.69734767873356868e-03,6.31456624195531724e-01,-1.98788971675422158e-03,-1.67439760903377848e-03,-1.02071405720948524e-02,-1.01823757030213846e-02,-2.88115092092536065e-02,-7.64902557064642830e-02,-4.20713883080698514e-01,-4.46435275806876197e-01,-5.08128462553680493e-01,
1.19185555856603960e-02,3.84168829913851756e-03,-8.23694077857227772e-03,-1.10296012834402817e-02,-5.09204231478038033e-03,6.30401688013131900e-01,-1.04880437351095486e-02,-1.46424053156874422e-02,-2.94629066476618760e-02,-4.05205266041160306e-01,-3.60473660315532296e-02,-9.43475751405287999e-02,-6.07968274751886639e-02,-4.76982225064064402e-01,-5.30745299367954670e-01,
1.19798514185597716e-02,2.07994424986172356e-03,-1.34224646918358580e-02,-5.53592950990595880e-03,-5.27892272460087075e-03,6.29346970261673189e-01,-1.93939971581369702e-03,-4.01197270617345645e-03,-2.75861435729637151e-02,-1.52383754676595103e-02,-4.34460948832884608e-01,-1.11867313206219454e-01,-5.05480957333688252e-01,-1.27165511978941465e-01,-5.33714376123511469e-01,
1.19650763579824525e-02,6.81796568839954445e-04,-1.24793409632671676e-02,-7.06841172072845709e-03,-5.73219384657168169e-03,6.28838077256556716e-01,-4.90444233340056324e-02,-1.43319657172846070e-02,-4.89718109762972420e-02,-4.56899209035265097e-01,-4.42420293370074491e-01,-1.36663179227894865e-01,-6.24452207766349257e-02,-1.28586755878102005e-01,-5.85341839830269550e-01,
1.20334533916656196e-02,6.43608201617240855e-04,-1.13193958344216094e-02,-8.30327673111570103e-03,-3.22339908980746707e-03,6.29310441405020016e-01,-1.37163390124313000e-02,-2.82671071167297089e-02,-3.39083949032379685e-03,-1.88746995954782899e-02,-5.36620748386820515e-02,-4.50947822714677149e-01,-5.39866112102804330e-01,-5.73498521672763051e-01,-2.01436508148478355e-01,
1.20442981286911915e-02,-2.35981641097487424e-04,-1.27322186401240007e-02,-1.22932120663469830e-02,-3.63837290203331259e-03,6.27776958038964272e-01,-1.49519681525066960e-02,-3.61926796762994774e-01,-4.32954573849082293e-03,-4.74817902072377840e-01,-6.64995584515055971e-02,-4.78709060296395372e-01,-6.16004935486782201e-02,-6.05386382247679711e-01,-2.04963402025102243e-01,
1.21114417629056281e-02,-3.97137727548544023e-04,-1.19977950681310966e-02,-9.80992331105432977e-03,-4.08068032632106972e-03,6.29262733305263056e-01,-2.72776357628654112e-02,-2.61956859430946665e+00,-6.87239684104322013e-01,-2.78748306666596508e-02,-4.66741079806777537e-01,-4.94454146567463226e-01,-5.65110769557002790e-01,-1.31340696826952041e-01,-2.10388936700761309e-01,
1.21599451917464903e-02,-8.22637636960344039e-04,-1.71359716483133126e-02,-1.46217451839059358e-02,-6.20240680126788509e-03,6.27616770644354283e-01,-3.89276516177938792e-02,-1.68395487083043867e-02,-2.15635340019065362e-02,-4.79496749921031529e-01,-5.00805210229691378e-01,-5.02868440508840497e-01,-6.71559864194967715e-02,-1.32817183966045443e-01,-2.10841196565196509e-01,

8,15
1.06958083990150543e+00,1.05611807924686163e+00,1.67094038975404320e-02,2.09352739287459316e-02,2.62824316121982662e-02,1.07906003167085740e+00,1.31488033597255537e-02,1.27391340440533574e-02,1.61664841686870869e-02,4.21920725430809551e-01,4.17822358775522318e-01,4.48451366704957277e-01,1.14699469306309967e-03,3.30131780008512208e-03,9.50775235503669575e-03,
1.15991661331748430e+00,1.05691964455021403e+00,2.15802036736254255e-02,2.26622712502785838e-02,2.61699445961860039e-02,1.16375830161662286e+00,1.28840347394417430e-02,1.65524001081864061e-02,1.93512682666960312e-02,3.85287125293679242e-02,4.51776122478159459e-01,4.46201322011324342e-01,4.15147556372319149e-01,4.34261626238851683e-03,1.25302967999341673e-02,
1.20977347187495954e+00,1.05653556062897658e+00,1.92956065645014732e-02,2.48916418576993308e-02,2.59742661676208367e-02,1.21185341612482134e+00,2.10004301159140358e-02,1.07057952500997922e-02,1.64746938627760124e-02,4.53749810258089359e-01,8.14762632957134608e-02,4.66532837331906425e-01,1.84633122697470649e-03,4.63057595492869178e-01,1.55659429875858058e-02,
1.25298612242363117e+00,1.05629778313614664e+00,2.07247056014004984e-02,2.62828995061888532e-02,2.69434010300848258e-02,1.25366791899247110e+00,7.02291517797269116e-02,3.65378838590777397e-02,2.14593140539883140e-02,4.14274336003437951e-02,8.27882602993453981e-02,5.02304177286006737e-01,4.95372772117792071e-01,5.01973530177345584e-01,2.03849303151370786e-02,
1.25617308338187894e+00,1.05605273741607797e+00,1.97751098801471313e-02,2.33543663890041879e-02,3.08297144813557585e-02,1.25681669158349618e+00,5.67761299533480618e-02,3.64438885025417103e-02,3.65181645812008432e-02,4.56650850151039012e-01,4.91993490449274318e-01,1.32801173902236835e-01,2.34180552838052876e-03,6.84030896548842166e-03,4.78960588610792160e-01,
1.27690000368599255e+00,1.05575329938502538e+00,1.99975174440838004e-02,2.60617754382792624e-02,3.09225996313366794e-02,1.27666402204489504e+00,3.98203874648841216e-01,2.77124871766888936e-02,4.91983567106983655e-01,4.11304474364431807e-02,4.98764194017306650e-01,1.32631206671014995e-01,5.46374515474628453e-01,8.95688343550711530e-03,5.36686025021179236e-01,
1.28511070707447916e+00,1.05508028447832070e+00,2.30972717864320054e-02,2.54485052555855282e-02,2.93794326582917376e-02,1.28471356934693071e+00,2.88563590810464676e-01,5.13300883161461052e-02,5.19222636807883803e-02,4.86404193540536101e-01,8.44623573759348406e-02,1.34572787497605928e-01,3.77918119444941658e-03,5.27238948853551603e-01,5.76693809448608707e-01,
1.29076564413820449e+00,1.05431915523799868e+00,1.97585694977598092e-02,2.45291917566100026e-02,3.02212398307518913e-02,1.28994300650124405e+00,2.24671141644151501e-01,3.02116149892900088e-01,4.10465960059065160e-01,4.32452103413332178e-02,8.62115734079908075e-02,1.34962231414414352e-01,5.85648996111201692e-01,5.87084627310267448e-01,6.09814290179842122e-01,

