1
1
15
0
(8 0
((0,0,0) (7,7,7) (0,0,0))
((8,0,0) (15,7,7) (0,0,0))
((0,8,0) (7,15,7) (0,0,0))
((8,8,0) (15,15,7) (0,0,0))
((0,0,8) (7,7,15) (0,0,0))
((8,0,8) (15,7,15) (0,0,0))
((0,8,8) (7,15,15) (0,0,0))
((8,8,8) (15,15,15) (0,0,0))
)
8
FabOnDisk: Cell_D_00000 0
FabOnDisk: Cell_D_00000 61527
FabOnDisk: Cell_D_00000 123055
FabOnDisk: Cell_D_00000 184583
FabOnDisk: Cell_D_00000 246112
FabOnDisk: Cell_D_00000 307640
FabOnDisk: Cell_D_00000 369169
FabOnDisk: Cell_D_00000 430698

8,15
1.21230853747445657e-02,8.88479103869623844e-03,-1.46653750365542557e-02,-1.01575289677476588e-02,-7.01485446479381547e-03,6.32371169838672142e-01,-1.89679622591056550e-03,-2.96228130378882676e-03,-1.23100096311803998e-02,-1.03799238546445349e-02,-2.84716317074881001e-02,-7.41244947016029970e-02,-4.24814768670771337e-01,-4.45642790746283712e-01,-5.08220232684131412e-01,
1.19223978690198157e-02,3.60220557121539555e-03,-8.15865395733929126e-03,-1.08479029207066719e-02,-5.44863581188015020e-03,6.30376912547609969e-01,-1.08819229329935076e-02,-1.49360491293800586e-02,-3.01868555823560231e-02,-4.07904438716749751e-01,-3.56682785696863514e-02,-9.15482047446235098e-02,-6.08769840440666760e-02,-4.81480326610899567e-01,-5.28886170533845013e-01,
1.19839269990686531e-02,2.00334362223168142e-03,-1.32643189149395310e-02,-5.77125420903799521e-03,-5.50062347154506304e-03,6.29200271966017799e-01,-1.98416355410911682e-03,-4.53716359466016864e-03,-2.61586711882666398e-02,-1.54755010288479631e-02,-4.35486568658941975e-01,-1.07441455565379651e-01,-5.07377329674608246e-01,-1.25098128733414693e-01,-5.30740090912398488e-01,
1.19678734932917308e-02,6.28181817775125078e-04,-1.26097122170404918e-02,-7.22289041817174467e-03,-6.05954472005281256e-03,6.28792656914737957e-01,-5.28097609250413880e-02,-1.41966381473522286e-02,-5.86070126135557895e-02,-4.57958397759760161e-01,-4.43477700107472395e-01,-1.31498483912855707e-01,-6.26777874855309475e-02,-1.26600274247677502e-01,-5.88109578521073928e-01,
1.20348631056461184e-02,6.08491726321908283e-04,-1.14114401497791545e-02,-7.87356151516381032e-03,-3.23604494422286351e-03,6.29194934569328512e-01,-1.43945508937506524e-02,-3.00872582235924280e-02,-3.51509321389159926e-03,-1.90997587000999239e-02,-5.23845382447379118e-02,-4.50221848012856918e-01,-5.40781505429273945e-01,-5.73924130699270507e-01,-1.99260598920487253e-01,
1.20432209073529587e-02,-2.43833888212083766e-04,-1.26506157622725216e-02,-1.26342450202868647e-02,-3.55197438178844922e-03,6.27873954919750732e-01,-1.43638529057155788e-02,-1.76770489996387292e+00,-3.97416360201321810e-03,-4.75075161803809709e-01,-6.50121449232366061e-02,-4.78884048556729891e-01,-6.20850509850559631e-02,-6.04223369771954344e-01,-2.01778538995430357e-01,
1.21118415604002747e-02,-3.99685551401057619e-04,-1.19886936096499849e-02,-9.75710395637952380e-03,-4.22534416514739556e-03,6.29472041047620445e-01,-2.82621556750966840e-02,-1.53750668061301866e-02,-2.51398407634464693e-02,-2.80781094249577153e-02,-4.65060258435812446e-01,-4.94758594403164054e-01,-5.64930796895158460e-01,-1.28374428042396432e-01,-2.06870941185719831e-01,
1.21601557155593398e-02,-8.26131054688742598e-04,-1.71605180340069705e-02,-1.47484506650216451e-02,-6.14793176045795239e-03,6.27652756469848527e-01,-3.18904958308625225e-02,-1.55853457357283346e-02,-2.10316604881269908e-02,-4.79402130255688230e-01,-4.99850240918156719e-01,-5.04950461092033120e-01,-6.77892950733080119e-02,-1.30693506864683284e-01,-2.07330752420086251e-01,

8,15
1.07723199785702328e+00,1.05612312653668372e+00,1.67402237873664692e-02,2.07150829723656386e-02,2.60834659024991831e-02,1.08611678889571950e+00,1.32263684476596304e-02,1.29318430748493821e-02,1.60119752800916039e-02,4.23895043295140050e-01,4.20929040043280356e-01,4.46682789385509871e-01,1.17043737719925520e-03,3.26514707159663523e-03,9.16071045120163061e-03,
1.16554523328515924e+00,1.05692819435171770e+00,2.15634076794339428e-02,2.28957686901172901e-02,2.59756260940771297e-02,1.16914743885637473e+00,1.40403039748559222e-02,1.72399408344096859e-02,1.92885824076484066e-02,3.84672118618565109e-02,4.54019532897171063e-01,4.45005543532965897e-01,4.16475821915921807e-01,4.30122001790898042e-03,1.20746162095525245e-02,
1.21230311225258536e+00,1.05654167370764496e+00,1.93651776083606508e-02,2.47930645051177498e-02,2.57961911003600913e-02,1.21430645587481711e+00,2.20134175214524233e-02,1.05950898768174227e-02,1.63037669159322544e-02,4.54234577421035790e-01,7.99840428511364998e-02,4.69028015651709762e-01,1.87577074293372075e-03,4.64987679372859564e-01,1.47804181378928760e-02,
1.25438380730818766e+00,1.05632552221501830e+00,2.05941963132775657e-02,2.61665258764223162e-02,2.67279878646939605e-02,1.25501198912596279e+00,7.62944908821639595e-02,3.90747427987698098e-02,2.13915471133049075e-02,4.18489165552183642e-02,8.17827626357532228e-02,5.03945281012084134e-01,4.98077259056616761e-01,5.03961449946178641e-01,1.93623212910765015e-02,
1.25716084857770083e+00,1.05598355057505833e+00,1.96527379736232410e-02,2.35142883608513639e-02,3.08256691445571579e-02,1.25776934030402265e+00,5.66670372911421694e-02,3.87829371641438200e-02,3.67698469448350246e-02,4.56647249042088810e-01,4.91445846848957424e-01,1.30818003769680918e-01,2.37254933271875083e-03,6.67420403832895241e-03,4.77975609355836994e-01,
1.27740483159106311e+00,1.05568035613111233e+00,1.98759239697686926e-02,2.62068601190485681e-02,3.08884916913108251e-02,1.27716099770285108e+00,2.29367584241582811e+00,2.96744379304887881e-02,2.60037464107577199e+00,4.13063770162295368e-02,4.97031258832300982e-01,1.30808967790005892e-01,5.47789935031548603e-01,8.75267669564582136e-03,5.36566265844387713e-01,
1.28522632348779897e+00,1.05504683302808155e+00,2.32221174452255652e-02,2.53940364807682707e-02,2.95139145134128422e-02,1.28482663793639795e+00,6.77759990923328115e-02,4.84393902007934640e-02,4.99958419150446920e-02,4.86236257202655786e-01,8.24736499044343291e-02,1.32077182073582572e-01,3.80482365392324773e-03,5.29162441580412701e-01,5.75416343737724101e-01,
1.29089879649881634e+00,1.05429109366961749e+00,1.96373323928167517e-02,2.43802994058359424e-02,3.02782317404662570e-02,1.29007266544412769e+00,4.55918101852157331e+00,4.23267405497997373e+00,1.06191205953017764e+01,4.35353974843965125e-02,8.47403376784394702e-02,1.32910749854975363e-01,5.85317200672656357e-01,5.85566507150090620e-01,6.10873863197387790e-01,

