1
1
15
0
(8 0
((0,0,0) (7,7,7) (0,0,0))
((8,0,0) (15,7,7) (0,0,0))
((0,8,0) (7,15,7) (0,0,0))
((8,8,0) (15,15,7) (0,0,0))
((0,0,8) (7,7,15) (0,0,0))
((8,0,8) (15,7,15) (0,0,0))
((0,8,8) (7,15,15) (0,0,0))
((8,8,8) (15,15,15) (0,0,0))
)
8
FabOnDisk: Cell_D_00000 0
FabOnDisk: Cell_D_00000 61527
FabOnDisk: Cell_D_00000 123055
FabOnDisk: Cell_D_00000 184583
FabOnDisk: Cell_D_00000 246112
FabOnDisk: Cell_D_00000 307640
FabOnDisk: Cell_D_00000 369169
FabOnDisk: Cell_D_00000 430698

8,15
1.2117253712753085e-02,9.4791917693520522e-03,-1.4698403265691216e-02,-1.0448741190139296e-02,-6.6973476787335687e-03,6.3145662419553172e-01,-1.9878897167542216e-03,-1.6743976090337785e-03,-1.0207140572094852e-02,-1.0182375703021385e-02,-2.8811509209253607e-02,-7.6490255706464283e-02,-4.2071388308069851e-01,-4.4643527580687620e-01,-5.0812846255368049e-01,
1.1918555585660396e-02,3.8416882991385176e-03,-8.2369407785722777e-03,-1.1029601283440282e-02,-5.0920423147803803e-03,6.3040168801313190e-01,-1.0488043735109549e-02,-1.4642405315687442e-02,-2.9462906647661876e-02,-4.0520526604116031e-01,-3.6047366031553230e-02,-9.4347575140528800e-02,-6.0796827475188664e-02,-4.7698222506406440e-01,-5.3074529936795467e-01,
1.1979851418559772e-02,2.0799442498617236e-03,-1.3422464691835858e-02,-5.5359295099059588e-03,-5.2789227246008708e-03,6.2934697026167319e-01,-1.9393997158136970e-03,-4.0119727061734565e-03,-2.7586143572963715e-02,-1.5238375467659510e-02,-4.3446094883288461e-01,-1.1186731320621945e-01,-5.0548095733368825e-01,-1.2716551197894146e-01,-5.3371437612351147e-01,
1.1965076357982453e-02,6.8179656883995444e-04,-1.2479340963267168e-02,-7.0684117207284571e-03,-5.7321938465716817e-03,6.2883807725655672e-01,-4.9044423334005632e-02,-1.4331965717284607e-02,-4.8971810976297242e-02,-4.5689920903526510e-01,-4.4242029337007449e-01,-1.3666317922789487e-01,-6.2445220776634926e-02,-1.2858675587810200e-01,-5.8534183983026955e-01,
1.2033453391665620e-02,6.4360820161724086e-04,-1.1319395834421609e-02,-8.3032767311157010e-03,-3.2233990898074671e-03,6.2931044140502002e-01,-1.3716339012431300e-02,-2.8267107116729709e-02,-3.3908394903237968e-03,-1.8874699595478290e-02,-5.3662074838682051e-02,-4.5094782271467715e-01,-5.3986611210280433e-01,-5.7349852167276305e-01,-2.0143650814847835e-01,
1.2044298128691192e-02,-2.3598164109748742e-04,-1.2732218640124001e-02,-1.2293212066346983e-02,-3.6383729020333126e-03,6.2777695803896427e-01,-1.4951968152506696e-02,-3.6192679676299477e-01,-4.3295457384908229e-03,-4.7481790207237784e-01,-6.6499558451505597e-02,-4.7870906029639537e-01,-6.1600493548678220e-02,-6.0538638224767971e-01,-2.0496340202510224e-01,
1.2111441762905628e-02,-3.9713772754854402e-04,-1.1997795068131097e-02,-9.8099233110543298e-03,-4.0806803263210697e-03,6.2926273330526306e-01,-2.7277635762865411e-02,-2.6195685943094666e+00,-6.8723968410432201e-01,-2.7874830666659651e-02,-4.6674107980677754e-01,-4.9445414656746323e-01,-5.6511076955700279e-01,-1.3134069682695204e-01,-2.1038893670076131e-01,
1.2159945191746490e-02,-8.2263763696034404e-04,-1.7135971648313313e-02,-1.4621745183905936e-02,-6.2024068012678851e-03,6.2761677064435428e-01,-3.8927651617793879e-02,-1.6839548708304387e-02,-2.1563534001906536e-02,-4.7949674992103153e-01,-5.0080521022969138e-01,-5.0286844050884050e-01,-6.7155986419496772e-02,-1.3281718396604544e-01,-2.1084119656519651e-01,

8,15
1.0695808399015054e+00,1.0561180792468616e+00,1.6709403897540432e-02,2.0935273928745932e-02,2.6282431612198266e-02,1.0790600316708574e+00,1.3148803359725554e-02,1.2739134044053357e-02,1.6166484168687087e-02,4.2192072543080955e-01,4.1782235877552232e-01,4.4845136670495728e-01,1.1469946930630997e-03,3.3013178000851221e-03,9.5077523550366957e-03,
1.1599166133174843e+00,1.0569196445502140e+00,2.1580203673625425e-02,2.2662271250278584e-02,2.6169944596186004e-02,1.1637583016166229e+00,1.2884034739441743e-02,1.6552400108186406e-02,1.9351268266696031e-02,3.8528712529367924e-02,4.5177612247815946e-01,4.4620132201132434e-01,4.1514755637231915e-01,4.3426162623885168e-03,1.2530296799934167e-02,
1.2097734718749595e+00,1.0565355606289766e+00,1.9295606564501473e-02,2.4891641857699331e-02,2.5974266167620837e-02,1.2118534161248213e+00,2.1000430115914036e-02,1.0705795250099792e-02,1.6474693862776012e-02,4.5374981025808936e-01,8.1476263295713461e-02,4.6653283733190642e-01,1.8463312269747065e-03,4.6305759549286918e-01,1.5565942987585806e-02,
1.2529861224236312e+00,1.0562977831361466e+00,2.0724705601400498e-02,2.6282899506188853e-02,2.6943401030084826e-02,1.2536679189924711e+00,7.0229151779726912e-02,3.6537883859077740e-02,2.1459314053988314e-02,4.1427433600343795e-02,8.2788260299345398e-02,5.0230417728600674e-01,4.9537277211779207e-01,5.0197353017734558e-01,2.0384930315137079e-02,
1.2561730833818789e+00,1.0560527374160780e+00,1.9775109880147131e-02,2.3354366389004188e-02,3.0829714481355758e-02,1.2568166915834962e+00,5.6776129953348062e-02,3.6443888502541710e-02,3.6518164581200843e-02,4.5665085015103901e-01,4.9199349044927432e-01,1.3280117390223684e-01,2.3418055283805288e-03,6.8403089654884217e-03,4.7896058861079216e-01,
1.2769000036859925e+00,1.0557532993850254e+00,1.9997517444083800e-02,2.6061775438279262e-02,3.0922599631336679e-02,1.2766640220448950e+00,3.9820387464884122e-01,2.7712487176688894e-02,4.9198356710698365e-01,4.1130447436443181e-02,4.9876419401730665e-01,1.3263120667101500e-01,5.4637451547462845e-01,8.9568834355071153e-03,5.3668602502117924e-01,
1.2851107070744792e+00,1.0550802844783207e+00,2.3097271786432005e-02,2.5448505255585528e-02,2.9379432658291738e-02,1.2847135693469307e+00,2.8856359081046468e-01,5.1330088316146105e-02,5.1922263680788380e-02,4.8640419354053610e-01,8.4462357375934841e-02,1.3457278749760593e-01,3.7791811944494166e-03,5.2723894885355160e-01,5.7669380944860871e-01,
1.2907656441382045e+00,1.0543191552379987e+00,1.9758569497759809e-02,2.4529191756610003e-02,3.0221239830751891e-02,1.2899430065012440e+00,2.2467114164415150e-01,3.0211614989290009e-01,4.1046596005906516e-01,4.3245210341333218e-02,8.6211573407990807e-02,1.3496223141441435e-01,5.8564899611120169e-01,5.8708462731026745e-01,6.0981429017984212e-01,

