1
1
15
0
(8 0
((0,0,0) (7,7,7) (0,0,0))
((8,0,0) (15,7,7) (0,0,0))
((0,8,0) (7,15,7) (0,0,0))
((8,8,0) (15,15,7) (0,0,0))
((0,0,8) (7,7,15) (0,0,0))
((8,0,8) (15,7,15) (0,0,0))
((0,8,8) (7,15,15) (0,0,0))
((8,8,8) (15,15,15) (0,0,0))
)
8
FabOnDisk: Cell_D_00000 0
FabOnDisk: Cell_D_00000 61527
FabOnDisk: Cell_D_00000 123055
FabOnDisk: Cell_D_00000 184583
FabOnDisk: Cell_D_00000 246112
FabOnDisk: Cell_D_00000 307640
FabOnDisk: Cell_D_00000 369169
FabOnDisk: Cell_D_00000 430698

8,15
1.22054802419270178e-02,1.07366372976874409e-02,-1.43824982483569189e-02,-1.19159165394864715e-02,-8.18109761672985991e-03,6.30526977837388203e-01,-2.01606471790230501e-03,-5.05670845024453245e-04,-7.18531441982404873e-03,-9.94577156931884289e-03,-3.12248199934663032e-02,-7.71505468042148201e-02,-4.13026739430513934e-01,-4.50064228046004766e-01,-5.04212682805236456e-01,
1.20099492117891286e-02,4.30837971833990859e-03,-9.23219383366584954e-03,-1.24411421332850901e-02,-6.64194238056419264e-03,6.29105772768823956e-01,-9.79885624603673080e-03,-1.55521273797237392e-02,-2.87901025415690966e-02,-4.01361956073863990e-01,-3.91609878143396664e-02,-9.54967247727716156e-02,-6.24820894355111803e-02,-4.68140034500151236e-01,-5.30030934303107770e-01,
1.20514052470474080e-02,2.09793703408373000e-03,-1.30213085622144786e-02,-5.95241684638669021e-03,-7.04185875444591526e-03,6.29730769678536140e-01,-1.86752844002147805e-03,-4.36409487354040213e-03,-3.27473416485102656e-02,-1.52588440569361525e-02,-4.32169360331174535e-01,-1.14922867039939050e-01,-5.05374797864929559e-01,-1.35796613615719430e-01,-5.34699856735208701e-01,
1.20569963613702761e-02,6.84827306647171679e-04,-1.30032875792572191e-02,-8.86826655432786798e-03,-7.03382696345995328e-03,6.28300572387931133e-01,-5.20188117815813325e-02,-1.41146474989013899e-02,-5.14532762830321941e-02,-4.56976584243110828e-01,-4.37951162259496984e-01,-1.40726594476648759e-01,-6.38962772166937337e-02,-1.36826861016276974e-01,-5.84130284654069687e-01,
1.20963600182799717e-02,7.48455791401233150e-04,-1.11264677961829261e-02,-1.00565681635614666e-02,-4.20250459110703932e-03,6.28557687930207942e-01,-1.23578157269951736e-02,-2.32123599884530678e-02,-5.48179624301443642e-03,-1.86180916721070573e-02,-5.82930602875316520e-02,-4.48768788770589677e-01,-5.38784763449974280e-01,-5.71098653086585806e-01,-2.04814535617437260e-01,
1.21186484559384026e-02,-2.00883854131172590e-04,-1.37999821161467820e-02,-1.15895614838532127e-02,-6.43149642926557283e-03,6.28359542021019735e-01,-1.61399474995309565e-02,-2.32521829973132005e-01,-6.77333620917111318e-03,-4.73910862209618200e-01,-7.23546668509622293e-02,-4.76778313676758547e-01,-6.32929856809001379e-02,-6.08121037826377608e-01,-2.07891450059074334e-01,
1.21763829082246686e-02,-4.24505270707274131e-04,-1.21505998284623003e-02,-1.08595613781174959e-02,-5.88693408404451692e-03,6.29003204815401062e-01,-2.68733874646349749e-02,-2.82567866667381484e-01,-5.34689023739372687e-02,-2.80825325840731513e-02,-4.71838216701346069e-01,-4.93519024813228402e-01,-5.63147149263938940e-01,-1.38871177990242206e-01,-2.11487395293560448e-01,
1.22249056808713327e-02,-8.33561215068260859e-04,-1.73571830378321593e-02,-1.53670342841865735e-02,-8.25219365310318406e-03,6.28125352016768113e-01,-4.90246369473746196e-02,-1.66686752059329521e-02,-2.10025056175239672e-02,-4.79405744684862578e-01,-5.04099863806506732e-01,-5.00819701754876889e-01,-6.82515612589827958e-02,-1.39973314487208539e-01,-2.11566770657087344e-01,

8,15
1.05482412111034263e+00,1.05576849166273790e+00,1.61420543299726355e-02,2.02320501452926439e-02,2.33852428277633168e-02,1.06800030014974712e+00,1.26857149332596682e-02,1.16251024794944632e-02,1.38574849323238047e-02,4.18065225746337976e-01,4.10199554524371957e-01,4.48355237472914614e-01,1.11815567750193304e-03,3.58097077154226860e-03,9.62104696241716448e-03,
1.14953361984578839e+00,1.05659730154001141e+00,2.05727567219542891e-02,2.15369151690866893e-02,2.43740393823166507e-02,1.15384199956412825e+00,1.22160568639807614e-02,1.48010199990889890e-02,1.80752014794477826e-02,3.97396237328791618e-02,4.46504699042030828e-01,4.46882796874959853e-01,4.12396104362718341e-01,4.72692432424442251e-03,1.27486510285652142e-02,
1.20848466098373564e+00,1.05630348997217749e+00,1.88291193824198025e-02,2.33377015695271015e-02,2.36371471244856517e-02,1.21058259801781931e+00,1.92505138775392153e-02,1.06849083003999860e-02,1.47702463975097724e-02,4.54449595892003178e-01,8.69133229070495616e-02,4.64522478263667216e-01,1.84675758349887430e-03,4.62640977318613089e-01,1.61662967030389709e-02,
1.25267157581038702e+00,1.05596055783005416e+00,1.93528587847450542e-02,2.44662283799298892e-02,2.56908444942944639e-02,1.25335640311703411e+00,7.19942369127459236e-02,3.55052063693537465e-02,1.96628829194597059e-02,4.20960218448691373e-02,8.77808716854166227e-02,5.01027225565832790e-01,4.95365448418263021e-01,4.99682268866997070e-01,2.12815785240185462e-02,
1.25246311788121267e+00,1.05592277200398943e+00,2.02010683948450342e-02,2.21805185370989623e-02,2.85276157076346029e-02,1.25321157367261393e+00,5.15392038027799593e-02,2.59710339307535898e-02,3.09703312313991327e-02,4.58653419492046688e-01,4.92602141195946031e-01,1.33242216022128435e-01,2.30098089678603714e-03,7.45880276287275330e-03,4.74700934942413721e-01,
1.27503049047792461e+00,1.05561038441330135e+00,1.87281459971999006e-02,2.44537362431275947e-02,2.82868108549801864e-02,1.27482960662379341e+00,9.70161791421272901e-02,2.40752775519650353e-02,1.82159913495492154e-01,4.21083042948800293e-02,5.03092198026017456e-01,1.33926433428074504e-01,5.42751801396526234e-01,9.79737911496790688e-03,5.33011366078334214e-01,
1.28523097003136844e+00,1.05493188870211951e+00,2.26307783572672477e-02,2.39338973211158552e-02,2.70046021591591016e-02,1.28480646476066118e+00,6.37006732214369237e-02,4.98063101679410078e-02,5.05945919855391585e-02,4.84972608185678999e-01,8.89442333656606660e-02,1.34793292049936175e-01,3.80827712825119839e-03,5.29568983381540015e-01,5.76515512837893374e-01,
1.29105081531349408e+00,1.05411638924070972e+00,1.93369605409181612e-02,2.31677713961887244e-02,2.77517432399199092e-02,1.29021725409842580e+00,1.12368568490191123e+00,8.35931145820360322e-01,2.04718781780903214e+00,4.40405285571871113e-02,9.05876681439740788e-02,1.35646547116615529e-01,5.85794048014741664e-01,5.93110021892211070e-01,6.08526530947821165e-01,

