1
1
15
0
(8 0
((0,0,0) (7,7,7) (0,0,0))
((8,0,0) (15,7,7) (0,0,0))
((0,8,0) (7,15,7) (0,0,0))
((8,8,0) (15,15,7) (0,0,0))
((0,0,8) (7,7,15) (0,0,0))
((8,0,8) (15,7,15) (0,0,0))
((0,8,8) (7,15,15) (0,0,0))
((8,8,8) (15,15,15) (0,0,0))
)
8
FabOnDisk: Cell_D_00000 0
FabOnDisk: Cell_D_00000 61527
FabOnDisk: Cell_D_00000 123055
FabOnDisk: Cell_D_00000 184583
FabOnDisk: Cell_D_00000 246112
FabOnDisk: Cell_D_00000 307640
FabOnDisk: Cell_D_00000 369169
FabOnDisk: Cell_D_00000 430698

8,15
1.19178018952005981e-02,6.31390840687472490e-03,-1.46532886429902292e-02,-8.68143643445654437e-03,-6.65600384860578348e-03,6.29778320565993255e-01,-1.97176280793707418e-03,-7.64024368792573863e-03,-1.74100964532178416e-02,-1.03151860599295184e-02,-2.72450214546837884e-02,-6.69363487529084644e-02,-4.44800211801538670e-01,-4.45969773658887125e-01,-5.06332374418598130e-01,
1.17192741565609933e-02,2.69783395421504570e-03,-8.12194893169512766e-03,-1.00368605971396622e-02,-4.90425178072835186e-03,6.32191717985435497e-01,-1.53257607764123293e-02,-1.53577336857290154e-02,-2.67342147110399206e-02,-4.16594459084236979e-01,-3.37389330687210345e-02,-8.19426867339472925e-02,-5.48010304341413068e-02,-5.01638432608177975e-01,-5.16236477897702106e-01,
1.18165727327075691e-02,1.65399250541755651e-03,-1.30851246651297187e-02,-4.13731564099117325e-03,-4.51557341747827086e-03,6.28558143044392281e-01,-2.08446467235273323e-03,-5.91586425630731202e-03,-2.04758758831868129e-02,-1.48434040158385572e-02,-4.40894431983904322e-01,-9.49749464027666163e-02,-5.13604470231824650e-01,-1.13979148228123606e-01,-5.40822666829638643e-01,
1.17686254068058195e-02,4.19343873578076007e-04,-1.20242091371489824e-02,-6.23593698567878347e-03,-6.65409582778707202e-03,6.28316268162585456e-01,-6.04766022780220541e-02,-3.14665133273307474e-02,-1.26055128013188300e-01,-4.61482262100862961e-01,-4.48709952932081380e-01,-1.15441718422949285e-01,-5.61897270339419275e-02,-1.16159984331880919e-01,-5.99005242767298052e-01,
1.18796427186212538e-02,4.50813190524129563e-04,-1.26409038761722044e-02,-6.53368334286187624e-03,-1.88915728108601105e-03,6.28902228482033254e-01,-1.48268030492927985e-02,-3.46838038556544354e-02,-1.84305807682957814e-03,-1.80007156433673599e-02,-4.79416062968700124e-02,-4.47470064338993112e-01,-5.38625033206299952e-01,-5.76283084615151431e-01,-1.86208340746742779e-01,
1.18335644906572453e-02,-2.94850488797699891e-04,-1.12142364380726535e-02,-1.29935619712567146e-02,-1.08147400853910759e-03,6.29306226559522952e-01,-6.73234666179163554e-02,-1.76808556292511243e+00,-7.49998229630873481e-01,-4.77249939943178547e-01,-5.88995872623339634e-02,-4.77643549275514223e-01,-5.65542257953542196e-02,-5.98811775626030052e-01,-1.83899516772458554e-01,
1.19588308397657935e-02,-3.67194340212541564e-04,-1.17335940271179502e-02,-8.34906255664096854e-03,-1.59999453771856801e-03,6.28728167539861937e-01,-2.83534542886180185e-02,-1.24720376108902499e-02,-2.04772816557231944e-02,-2.56732861791209750e-02,-4.60358529586858856e-01,-4.95048689473683468e-01,-5.72270453546478985e-01,-1.19181254618480240e-01,-1.91737288546877771e-01,
1.19321967508865881e-02,-8.18287732359506163e-04,-1.60112996100622157e-02,-1.37067127701544257e-02,-3.77449538638798422e-03,6.25718404677657825e-01,-1.58809833353405289e-01,-1.71936047812748551e-02,-1.92244051337087871e-02,-4.81893189153945745e-01,-4.95640960124329732e-01,-5.09932224382952715e-01,-6.09799380876553457e-02,-1.21173650734657468e-01,-1.93136540870353868e-01,

8,15
1.11458397154107103e+00,1.05672199784236542e+00,1.71656996375803596e-02,2.19003664225703408e-02,2.76795233226791934e-02,1.12089787994794565e+00,1.36986431034209766e-02,1.36146925253282803e-02,1.81370487755097183e-02,4.32370336526712418e-01,4.36184691549035941e-01,4.35494014319768141e-01,1.17149795530226337e-03,3.14045257537944262e-03,8.14684715715242348e-03,
1.18942578957640177e+00,1.05751004950627325e+00,2.19148845573505224e-02,2.29137648861829461e-02,2.76169873946199712e-02,1.19212362353061674e+00,1.74775398740491389e-02,1.96669897371519291e-02,1.96604104254659920e-02,3.47286006600722105e-02,4.63744894643754679e-01,4.60146225973149692e-01,4.24917847966203521e-01,4.08495984231521669e-03,1.05803894312882178e-02,
1.22454682313453955e+00,1.05709993728187390e+00,1.92151483827951788e-02,2.48138124196364343e-02,2.74713540256681932e-02,1.22620081563995709e+00,3.35833802521663810e-02,1.58591756778550183e-02,1.83957110995737610e-02,4.52453037796935909e-01,7.41765923823762968e-02,4.81634465020562008e-01,1.80824341128741684e-03,4.75292399849747582e-01,1.26756775431871877e-02,
1.25939722959707856e+00,1.05694278524004548e+00,2.10970275954706632e-02,2.67531418386463687e-02,2.72967724983642218e-02,1.25981657347065656e+00,1.01015205412786385e-01,6.15085181400352177e-02,2.33344597464297185e-02,3.79684944070349181e-02,7.55163876672783202e-02,5.10513272329719880e-01,5.05659113748767375e-01,5.12538091723290901e-01,1.63596876174411932e-02,
1.26096633974784389e+00,1.05652882700112705e+00,1.86950398300264817e-02,2.38419658778934035e-02,3.29608754293699083e-02,1.26141715293836798e+00,6.33949576210170868e-02,4.50525581866179359e-02,4.07889856211956919e-02,4.53737212905645393e-01,4.89308715625472790e-01,1.21527999715166313e-01,2.24663855652029645e-03,6.10356376228777739e-03,4.81397920592310458e-01,
1.27811995792465583e+00,1.05621265318605362e+00,2.11541184117093953e-02,2.66165630332868275e-02,3.34431450954350354e-02,1.27782510743585820e+00,6.09516094427079880e-01,3.17135445638399016e-02,6.64798889771566537e-01,3.74673561054272714e-02,4.91447479353308569e-01,1.20371635333371987e-01,5.51715418796217882e-01,7.90343763214212437e-03,5.33118487751123693e-01,
1.28339419924387155e+00,1.05555943496064253e+00,2.29436866016041463e-02,2.61601711756149560e-02,3.21932428240872537e-02,1.28303705324250350e+00,9.22932788322728265e-02,5.33184035401430001e-02,5.27900778137290888e-02,4.91239460197336275e-01,7.70965404191683162e-02,1.23345713623598252e-01,3.47883578210799816e-03,5.37701769259681606e-01,5.71669491240293981e-01,
1.28935675060384880e+00,1.05487639222927276e+00,2.07920702221975791e-02,2.48559831774975253e-02,3.30362767787515527e-02,1.28853846287148932e+00,2.16602888139761784e+00,2.74165734518581594e+00,1.27539646255751538e+00,3.99000947145276563e-02,7.92277231712492647e-02,1.23759641374832821e-01,5.88778831101577027e-01,5.78583837435362236e-01,6.12337401277763038e-01,

