1
1
15
0
(8 0
((0,0,0) (7,7,7) (0,0,0))
((8,0,0) (15,7,7) (0,0,0))
((0,8,0) (7,15,7) (0,0,0))
((8,8,0) (15,15,7) (0,0,0))
((0,0,8) (7,7,15) (0,0,0))
((8,0,8) (15,7,15) (0,0,0))
((0,8,8) (7,15,15) (0,0,0))
((8,8,8) (15,15,15) (0,0,0))
)
8
FabOnDisk: Cell_D_00000 0
FabOnDisk: Cell_D_00000 61527
FabOnDisk: Cell_D_00000 123055
FabOnDisk: Cell_D_00000 184583
FabOnDisk: Cell_D_00000 246112
FabOnDisk: Cell_D_00000 307640
FabOnDisk: Cell_D_00000 369169
FabOnDisk: Cell_D_00000 430698

8,15
1.1917801895200598e-02,6.3139084068747249e-03,-1.4653288642990229e-02,-8.6814364344565444e-03,-6.6560038486057835e-03,6.2977832056599325e-01,-1.9717628079370742e-03,-7.6402436879257386e-03,-1.7410096453217842e-02,-1.0315186059929518e-02,-2.7245021454683788e-02,-6.6936348752908464e-02,-4.4480021180153867e-01,-4.4596977365888713e-01,-5.0633237441859813e-01,
1.1719274156560993e-02,2.6978339542150457e-03,-8.1219489316951277e-03,-1.0036860597139662e-02,-4.9042517807283519e-03,6.3219171798543550e-01,-1.5325760776412329e-02,-1.5357733685729015e-02,-2.6734214711039921e-02,-4.1659445908423698e-01,-3.3738933068721035e-02,-8.1942686733947293e-02,-5.4801030434141307e-02,-5.0163843260817798e-01,-5.1623647789770211e-01,
1.1816572732707569e-02,1.6539925054175565e-03,-1.3085124665129719e-02,-4.1373156409911733e-03,-4.5155734174782709e-03,6.2855814304439228e-01,-2.0844646723527332e-03,-5.9158642563073120e-03,-2.0475875883186813e-02,-1.4843404015838557e-02,-4.4089443198390432e-01,-9.4974946402766616e-02,-5.1360447023182465e-01,-1.1397914822812361e-01,-5.4082266682963864e-01,
1.1768625406805820e-02,4.1934387357807601e-04,-1.2024209137148982e-02,-6.2359369856787835e-03,-6.6540958277870720e-03,6.2831626816258546e-01,-6.0476602278022054e-02,-3.1466513327330747e-02,-1.2605512801318830e-01,-4.6148226210086296e-01,-4.4870995293208138e-01,-1.1544171842294929e-01,-5.6189727033941927e-02,-1.1615998433188092e-01,-5.9900524276729805e-01,
1.1879642718621254e-02,4.5081319052412956e-04,-1.2640903876172204e-02,-6.5336833428618762e-03,-1.8891572810860111e-03,6.2890222848203325e-01,-1.4826803049292799e-02,-3.4683803855654435e-02,-1.8430580768295781e-03,-1.8000715643367360e-02,-4.7941606296870012e-02,-4.4747006433899311e-01,-5.3862503320629995e-01,-5.7628308461515143e-01,-1.8620834074674278e-01,
1.1833564490657245e-02,-2.9485048879769989e-04,-1.1214236438072653e-02,-1.2993561971256715e-02,-1.0814740085391076e-03,6.2930622655952295e-01,-6.7323466617916355e-02,-1.7680855629251124e+00,-7.4999822963087348e-01,-4.7724993994317855e-01,-5.8899587262333963e-02,-4.7764354927551422e-01,-5.6554225795354220e-02,-5.9881177562603005e-01,-1.8389951677245855e-01,
1.1958830839765794e-02,-3.6719434021254156e-04,-1.1733594027117950e-02,-8.3490625566409685e-03,-1.5999945377185680e-03,6.2872816753986194e-01,-2.8353454288618019e-02,-1.2472037610890250e-02,-2.0477281655723194e-02,-2.5673286179120975e-02,-4.6035852958685886e-01,-4.9504868947368347e-01,-5.7227045354647899e-01,-1.1918125461848024e-01,-1.9173728854687777e-01,
1.1932196750886588e-02,-8.1828773235950616e-04,-1.6011299610062216e-02,-1.3706712770154426e-02,-3.7744953863879842e-03,6.2571840467765782e-01,-1.5880983335340529e-01,-1.7193604781274855e-02,-1.9224405133708787e-02,-4.8189318915394574e-01,-4.9564096012432973e-01,-5.0993222438295271e-01,-6.0979938087655346e-02,-1.2117365073465747e-01,-1.9313654087035387e-01,

8,15
1.1145839715410710e+00,1.0567219978423654e+00,1.7165699637580360e-02,2.1900366422570341e-02,2.7679523322679193e-02,1.1208978799479457e+00,1.3698643103420977e-02,1.3614692525328280e-02,1.8137048775509718e-02,4.3237033652671242e-01,4.3618469154903594e-01,4.3549401431976814e-01,1.1714979553022634e-03,3.1404525753794426e-03,8.1468471571524235e-03,
1.1894257895764018e+00,1.0575100495062733e+00,2.1914884557350522e-02,2.2913764886182946e-02,2.7616987394619971e-02,1.1921236235306167e+00,1.7477539874049139e-02,1.9666989737151929e-02,1.9660410425465992e-02,3.4728600660072211e-02,4.6374489464375468e-01,4.6014622597314969e-01,4.2491784796620352e-01,4.0849598423152167e-03,1.0580389431288218e-02,
1.2245468231345396e+00,1.0570999372818739e+00,1.9215148382795179e-02,2.4813812419636434e-02,2.7471354025668193e-02,1.2262008156399571e+00,3.3583380252166381e-02,1.5859175677855018e-02,1.8395711099573761e-02,4.5245303779693591e-01,7.4176592382376297e-02,4.8163446502056201e-01,1.8082434112874168e-03,4.7529239984974758e-01,1.2675677543187188e-02,
1.2593972295970786e+00,1.0569427852400455e+00,2.1097027595470663e-02,2.6753141838646369e-02,2.7296772498364222e-02,1.2598165734706566e+00,1.0101520541278639e-01,6.1508518140035218e-02,2.3334459746429718e-02,3.7968494407034918e-02,7.5516387667278320e-02,5.1051327232971988e-01,5.0565911374876737e-01,5.1253809172329090e-01,1.6359687617441193e-02,
1.2609663397478439e+00,1.0565288270011270e+00,1.8695039830026482e-02,2.3841965877893403e-02,3.2960875429369908e-02,1.2614171529383680e+00,6.3394957621017087e-02,4.5052558186617936e-02,4.0788985621195692e-02,4.5373721290564539e-01,4.8930871562547279e-01,1.2152799971516631e-01,2.2466385565202964e-03,6.1035637622877774e-03,4.8139792059231046e-01,
1.2781199579246558e+00,1.0562126531860536e+00,2.1154118411709395e-02,2.6616563033286827e-02,3.3443145095435035e-02,1.2778251074358582e+00,6.0951609442707988e-01,3.1713544563839902e-02,6.6479888977156654e-01,3.7467356105427271e-02,4.9144747935330857e-01,1.2037163533337199e-01,5.5171541879621788e-01,7.9034376321421244e-03,5.3311848775112369e-01,
1.2833941992438715e+00,1.0555594349606425e+00,2.2943686601604146e-02,2.6160171175614956e-02,3.2193242824087254e-02,1.2830370532425035e+00,9.2293278832272826e-02,5.3318403540143000e-02,5.2790077813729089e-02,4.9123946019733628e-01,7.7096540419168316e-02,1.2334571362359825e-01,3.4788357821079982e-03,5.3770176925968161e-01,5.7166949124029398e-01,
1.2893567506038488e+00,1.0548763922292728e+00,2.0792070222197579e-02,2.4855983177497525e-02,3.3036276778751553e-02,1.2885384628714893e+00,2.1660288813976178e+00,2.7416573451858159e+00,1.2753964625575154e+00,3.9900094714527656e-02,7.9227723171249265e-02,1.2375964137483282e-01,5.8877883110157703e-01,5.7858383743536224e-01,6.1233740127776304e-01,

