1
1
15
0
(8 0
((0,0,0) (7,7,7) (0,0,0))
((8,0,0) (15,7,7) (0,0,0))
((0,8,0) (7,15,7) (0,0,0))
((8,8,0) (15,15,7) (0,0,0))
((0,0,8) (7,7,15) (0,0,0))
((8,0,8) (15,7,15) (0,0,0))
((0,8,8) (7,15,15) (0,0,0))
((8,8,8) (15,15,15) (0,0,0))
)
8
FabOnDisk: Cell_D_00000 0
FabOnDisk: Cell_D_00000 61527
FabOnDisk: Cell_D_00000 123055
FabOnDisk: Cell_D_00000 184583
FabOnDisk: Cell_D_00000 246112
FabOnDisk: Cell_D_00000 307640
FabOnDisk: Cell_D_00000 369169
FabOnDisk: Cell_D_00000 430698

8,15
1.19437347490399647e-02,6.01174860900020435e-03,-1.44344859785268762e-02,-8.55936985448329558e-03,-7.12121084609762707e-03,6.28993084650380840e-01,-1.98715335159638587e-03,-7.60790363865947779e-03,-1.69504170856443689e-02,-1.04448680236882141e-02,-2.69470178923239545e-02,-6.46151094338994203e-02,-4.47991057017906036e-01,-4.49717187519455885e-01,-5.05035950073262074e-01,
1.17450421279112482e-02,2.58849499323120149e-03,-8.06415694205031910e-03,-9.83388698836329227e-03,-5.43857250674188546e-03,6.33255756845327422e-01,-1.65632923917614430e-02,-1.33598230164104926e-02,-2.31153478305738264e-02,-4.18440499851550962e-01,-3.34293097635994588e-02,-7.91324055917986269e-02,-5.44730509429351556e-02,-5.04456211077864092e-01,-5.13233681174039114e-01,
1.18318861537121869e-02,1.61359436613689650e-03,-1.29317231123008188e-02,-4.20652156624599840e-03,-5.05562566692087552e-03,6.29110365243960024e-01,-2.14807176071601675e-03,-6.07910330524152366e-03,-1.69973706510073187e-02,-1.50183755268510355e-02,-4.41583442126860959e-01,-9.04840780790824306e-02,-5.14829080953489449e-01,-1.12017505923569766e-01,-5.43320696986571594e-01,
1.17882862057962327e-02,3.89530690671594155e-04,-1.18855823315867169e-02,-6.09852062415809724e-03,-8.07119882921850801e-03,6.28621656382173599e-01,-6.33825560109566588e-02,-3.17657402871477368e-02,-1.26124411611322651e-01,-4.62091888667962414e-01,-4.49405272310280157e-01,-1.10151988825397187e-01,-5.70061182667332411e-02,-1.14863495500998641e-01,-6.00465624064287717e-01,
1.18811419611676797e-02,4.22514708159997629e-04,-1.27857253249257698e-02,-6.39025561427054682e-03,-2.03912504399455727e-03,6.28836564105043183e-01,-1.52315976844693331e-02,-3.61883101412451141e-02,-2.01502840544760635e-03,-1.81095823463578443e-02,-4.67966993813813820e-02,-4.46774759626647699e-01,-5.39476184975506201e-01,-5.76061487513455428e-01,-1.84312828305605275e-01,
1.18496029350438018e-02,-2.89968327992017863e-04,-1.11757764511669459e-02,-1.34754655897272139e-02,-1.48095770587960713e-03,6.29250893210081763e-01,-9.10763306141142981e-02,-1.55967594878355742e+00,-3.47655875953245652e-01,-4.77445458908530851e-01,-5.76264628853484645e-02,-4.77872066625816327e-01,-5.70003866986803637e-02,-5.97108662502431886e-01,-1.81687187993985783e-01,
1.19619398722767209e-02,-3.88692801554371703e-04,-1.15864420133641420e-02,-8.48365486151066162e-03,-1.75409912423305728e-03,6.28488401017634146e-01,-2.36705838706759604e-02,-1.20467623284576351e-02,-2.00710513478784408e-02,-2.58170002367959506e-02,-4.58597825378906532e-01,-4.94930516887976513e-01,-5.72019159139707689e-01,-1.16145463254811857e-01,-1.88570236831444055e-01,
1.19304550214065046e-02,-8.32293267021023790e-04,-1.58367997487712867e-02,-1.35944758289897622e-02,-3.86460015674401983e-03,6.25299205169378425e-01,-1.35046526948280038e-01,-2.77788625698529648e-02,-1.90328617511038647e-02,-4.81694397575933853e-01,-4.94554475826992024e-01,-5.11606292551987307e-01,-6.18615448235923099e-02,-1.19475795808365218e-01,-1.90142775708436129e-01,

8,15
1.12026335662431453e+00,1.05690504043065392e+00,1.70110982933812313e-02,2.14477970253460076e-02,2.75589990865937572e-02,1.12627510523331464e+00,1.37811780674681125e-02,1.39842493373234580e-02,1.80738350041712431e-02,4.33615074465805439e-01,4.38168603743493090e-01,4.33235735953611700e-01,1.19365283429935217e-03,3.10764718275493776e-03,7.83363755820066544e-03,
1.19306272517669676e+00,1.05770297163475124e+00,2.19835054610924702e-02,2.29084259344256025e-02,2.74000881231724683e-02,1.19565122016992786e+00,1.78708874627775405e-02,1.99774564308505889e-02,1.97714838827255657e-02,3.45052134811927314e-02,4.64754727031256420e-01,4.62919297605772329e-01,4.25591743526127719e-01,4.05430739633844388e-03,1.01896900798167586e-02,
1.22625587486354926e+00,1.05717943460551544e+00,1.91320647732206375e-02,2.45537730860503969e-02,2.72119432520473298e-02,1.22786946922968609e+00,3.45024277251143596e-02,1.63352185568939115e-02,1.82435867459398125e-02,4.52462716901729012e-01,7.28286920366449930e-02,4.83098505519585109e-01,1.83751992754499862e-03,4.76842168050267301e-01,1.20031803825315399e-02,
1.26001606920195908e+00,1.05710226001003460e+00,2.13202128325187812e-02,2.67916439411932279e-02,2.72892478526597163e-02,1.26040559989263068e+00,1.04095008475168477e-01,6.51115965511236128e-02,2.37791424823251968e-02,3.84701391324826780e-02,7.48220780696969151e-02,5.11083089630542831e-01,5.07707998358475021e-01,5.14079938058080055e-01,1.55198524424047558e-02,
1.26175311112043809e+00,1.05631309606017365e+00,1.86029675824052922e-02,2.40371330855709102e-02,3.31130180884202235e-02,1.26217562582859810e+00,5.91253238509563545e-02,4.97806511585938624e-02,4.49112500660863723e-02,4.53710964935189476e-01,4.88234127302558385e-01,1.19550536013077441e-01,2.28052465126159145e-03,5.95220014518089025e-03,4.85311573224743553e-01,
1.27885601748670785e+00,1.05647185907462537e+00,2.14578982919490791e-02,2.66352080922810479e-02,3.35619876218220398e-02,1.27856604915871586e+00,5.96528849709468539e-02,3.63135092447678456e-02,6.53608981391615440e-02,3.77538154605416426e-02,4.90095134908455965e-01,1.19016301881056011e-01,5.52829545241147136e-01,7.72868282888439923e-03,5.33401066695357251e-01,
1.28374618942393659e+00,1.05563326499104138e+00,2.29602951409158713e-02,2.57223350839602058e-02,3.19079104782910156e-02,1.28335749662238219e+00,1.50159759194024778e+00,2.60116916747510007e+00,7.38739304025875398e+00,4.90957142807994185e-01,7.49542742095586356e-02,1.20909495359047686e-01,3.51347169606151897e-03,5.39496159121143570e-01,5.70074808244346420e-01,
1.28968451652939464e+00,1.05469298900198072e+00,2.03311967095999475e-02,2.45177262726700637e-02,3.31466159562941592e-02,1.28885222326237359e+00,7.79448698229345105e+00,9.49020270899940854e+00,5.28114174798618308e+00,4.06920562317242551e-02,7.79266857687025138e-02,1.21599914857307395e-01,5.88497142844070842e-01,5.76807240477325900e-01,6.13008393656788164e-01,

