1
1
15
0
(8 0
((0,0,0) (7,7,7) (0,0,0))
((8,0,0) (15,7,7) (0,0,0))
((0,8,0) (7,15,7) (0,0,0))
((8,8,0) (15,15,7) (0,0,0))
((0,0,8) (7,7,15) (0,0,0))
((8,0,8) (15,7,15) (0,0,0))
((0,8,8) (7,15,15) (0,0,0))
((8,8,8) (15,15,15) (0,0,0))
)
8
FabOnDisk: Cell_D_00000 0
FabOnDisk: Cell_D_00000 61527
FabOnDisk: Cell_D_00000 123055
FabOnDisk: Cell_D_00000 184583
FabOnDisk: Cell_D_00000 246112
FabOnDisk: Cell_D_00000 307640
FabOnDisk: Cell_D_00000 369169
FabOnDisk: Cell_D_00000 430698

8,15
1.22309026318484886e-02,1.26582522712729208e-02,-1.43038597571640037e-02,-1.25403387614720398e-02,-8.25865438348935034e-03,6.30046557620975056e-01,-2.06948638813132845e-03,-5.13579185487084361e-04,-3.49581988035439295e-03,-9.95342177491668513e-03,-3.20112289410492412e-02,-8.11894373551837190e-02,-4.02475090483438658e-01,-4.49107066241155650e-01,-5.01918730205711539e-01,
1.20373977360412141e-02,5.03627331552710961e-03,-9.53307419677646914e-03,-1.28946976671563875e-02,-6.83574564457766279e-03,6.28382294537829900e-01,-8.56829679277171588e-03,-1.23937507210004974e-02,-2.61561692359599390e-02,-3.96820979150965591e-01,-4.03045449801110456e-02,-1.00721066443836021e-01,-6.48090228258048073e-02,-4.67918876565183051e-01,-5.32531147308810127e-01,
1.20703786492890007e-02,2.32469766243805030e-03,-1.32057988628160421e-02,-6.23851108463363991e-03,-7.35718953671327287e-03,6.29459945653072950e-01,-1.78994947219900829e-03,-4.31442024850685335e-03,-3.55777927736959862e-02,-1.54879248017428250e-02,-4.29318500955495230e-01,-1.22246451634763068e-01,-5.00863744125481514e-01,-1.40153961919113362e-01,-5.41387281201681891e-01,
1.20859072010836826e-02,8.15084883668200670e-04,-1.29460394786054585e-02,-9.04916588545285130e-03,-7.92949015610807176e-03,6.28225851010487002e-01,-4.60758482494930816e-02,-9.69693188348161490e-03,-3.62451403362012217e-02,-4.54981343043912967e-01,-4.35053427783907598e-01,-1.49873941872836480e-01,-6.63846583368701559e-02,-1.41508280333368874e-01,-5.76948167613267948e-01,
1.21152990489414476e-02,8.54232947742378625e-04,-1.14423226888265162e-02,-1.08198839852652398e-02,-4.67666240999158392e-03,6.28573889739371339e-01,-1.04563518273174359e-02,-1.98378144868012335e-02,-5.87947495173265187e-03,-1.90111647162027886e-02,-6.09797764443587575e-02,-4.49320791964291200e-01,-5.37749583601830672e-01,-5.67947157269527603e-01,-2.12938887465065535e-01,
1.21394879831386929e-02,-1.52361396453993549e-04,-1.40110703938912326e-02,-1.13776808167586861e-02,-7.09240129763106641e-03,6.27980842552885665e-01,-1.91193746432151632e-02,-2.65209512464918973e-01,-8.33753063732184906e-03,-4.72648028369466511e-01,-7.59346471400708101e-02,-4.76236028631787156e-01,-6.54011878481695341e-02,-6.08686232137483518e-01,-2.15204831850536238e-01,
1.21990624719589269e-02,-4.23216790824215922e-04,-1.22949584677028555e-02,-1.09983194850045291e-02,-6.37264985492305615e-03,6.28987383722980020e-01,-2.65081493002362334e-02,-1.02756582506781838e-01,-2.42721914227662441e-02,-2.90606087354396206e-02,-4.73774790806265278e-01,-4.91819284884699670e-01,-5.59470506363606179e-01,-1.43592137522095625e-01,-2.18085440994128910e-01,
1.22507821345065222e-02,-8.17480913535627665e-04,-1.73996814900753902e-02,-1.52213632175842491e-02,-8.86011235200760694e-03,6.28554384119233367e-01,-5.39927397968827383e-02,-1.76803997419839147e-02,-2.20096456806606507e-02,-4.78226459347967592e-01,-5.05279522057327179e-01,-4.96320225836708595e-01,-7.02862861921765281e-02,-1.44470634709732870e-01,-2.18295545507662642e-01,

8,15
1.03451350113263096e+00,1.05566099262423263e+00,1.58858840130469171e-02,1.96847341477031784e-02,2.26713897438632142e-02,1.06791537961579097e+00,1.20934771184560141e-02,1.12870752054446480e-02,1.33917698253021231e-02,4.12670896929389741e-01,4.03747999997345508e-01,4.50936741422949705e-01,1.11498681815559914e-03,3.66696568348558356e-03,1.02401297475097301e-02,
1.13529759932294194e+00,1.05650311844304579e+00,2.02331447666329670e-02,2.10074918799648819e-02,2.41472043700540276e-02,1.14033387263846908e+00,1.06619688648174598e-02,1.33681985631006993e-02,1.74717648892178598e-02,4.14664015880853443e-02,4.39952033915018470e-01,4.52461166819039695e-01,4.07481497713331309e-01,4.86012552673119758e-03,1.36403583009626142e-02,
1.20117222502241461e+00,1.05626565101109882e+00,1.85610617573477230e-02,2.34127915025151880e-02,2.32220195402439503e-02,1.20349692268485264e+00,1.77686820902088621e-02,9.52436022962345474e-03,1.41636660488431640e-02,4.53967225897071947e-01,8.99049542381672451e-02,4.57406052771935467e-01,1.87064560292094645e-03,4.57397652849902747e-01,1.75477036767814586e-02,
1.24915243493402506e+00,1.05592096605442665e+00,1.93101060364548639e-02,2.42341891310231053e-02,2.53548125559989908e-02,1.24996751981769316e+00,6.13480716359927694e-02,2.79536530992180454e-02,1.89534755130600190e-02,4.34700071510432384e-02,9.03981149804426731e-02,4.96419967699041509e-01,4.90981491055626496e-01,4.94988674323788014e-01,2.32255478542989918e-02,
1.24962360679853113e+00,1.05587883348938383e+00,2.00574138596345715e-02,2.16695974009305965e-02,2.76001631075469198e-02,1.25047783974627347e+00,4.66520764931663903e-02,2.02274320251385128e-02,2.90645020308843670e-02,4.60320459788754577e-01,4.92058193236675212e-01,1.37206228042582368e-01,2.34387465898815844e-03,7.81705641313769697e-03,4.75354276989502167e-01,
1.27447230952509627e+00,1.05555841123275673e+00,1.86190339102000821e-02,2.38222141214056264e-02,2.73844369101528679e-02,1.27431994812864224e+00,5.89776816839468199e-02,2.26629985783118743e-02,1.35895642912647885e-01,4.34221603427782932e-02,5.05100264798248877e-01,1.38232040232837139e-01,5.40103575492392629e-01,1.03116163057360623e-02,5.33207456250764045e-01,
1.28505794686482600e+00,1.05485921474071498e+00,2.23695793295163592e-02,2.37648043034921902e-02,2.61869141641269121e-02,1.28463473007400175e+00,6.22735853140332779e-02,4.94737088398944369e-02,5.17650945185293837e-02,4.82571993272421951e-01,9.18466194284922877e-02,1.39084205156844998e-01,3.93750857037904710e-03,5.32234830143691884e-01,5.76664268537065983e-01,
1.29122295070904802e+00,1.05400774115147411e+00,1.91338876089423710e-02,2.29920779036415363e-02,2.67253978139463041e-02,1.29040546979551229e+00,2.85812282321819766e-01,2.40225401908152336e-01,5.80785592856570609e-01,4.54457346183256283e-02,9.33076896721519444e-02,1.39837709373464597e-01,5.83976824526251326e-01,5.95377811598028606e-01,6.05322085263592102e-01,

