1
1
15
0
(8 0
((0,0,0) (7,7,7) (0,0,0))
((8,0,0) (15,7,7) (0,0,0))
((0,8,0) (7,15,7) (0,0,0))
((8,8,0) (15,15,7) (0,0,0))
((0,0,8) (7,7,15) (0,0,0))
((8,0,8) (15,7,15) (0,0,0))
((0,8,8) (7,15,15) (0,0,0))
((8,8,8) (15,15,15) (0,0,0))
)
8
FabOnDisk: Cell_D_00000 0
FabOnDisk: Cell_D_00000 61527
FabOnDisk: Cell_D_00000 123055
FabOnDisk: Cell_D_00000 184583
FabOnDisk: Cell_D_00000 246112
FabOnDisk: Cell_D_00000 307640
FabOnDisk: Cell_D_00000 369169
FabOnDisk: Cell_D_00000 430698

8,15
1.23348705376503422e-02,3.42283156558105400e-02,-1.40292772164822589e-02,-1.53068167978918056e-02,-1.00092207835935504e-02,6.27698481627324556e-01,-2.08436331134704547e-03,-9.35380410992691139e-04,-2.82462395098753228e-04,-9.79550138605672638e-03,-3.69717300931917126e-02,-1.08837889864543319e-01,-3.70538528418610791e-01,-4.22432715234276057e-01,-4.63708289133693885e-01,
1.21189574440822550e-02,1.42717503022221914e-02,-1.01685038768479039e-02,-1.51218449010904563e-02,-9.91550821348236022e-03,6.28102497449796404e-01,-9.58781842987361035e-03,-5.35431075467060610e-04,-1.11882176256171027e-03,-3.67668551603694937e-01,-4.76211765510582002e-02,-1.36891471555379507e-01,-7.68543089562558623e-02,-4.66357401387621329e-01,-5.21878601788432261e-01,
1.21273892546564978e-02,4.79891623435827006e-03,-1.37263475212387898e-02,-9.20064473964195273e-03,-9.00937062650554107e-03,6.28205649199931493e-01,-1.83647252844815331e-03,-9.15059436559761616e-03,-3.96412754411835239e-02,-1.66626300691161688e-02,-4.10305764321256539e-01,-1.73374468715215807e-01,-4.61708109830300195e-01,-1.68818257825684381e-01,-5.66659055601424932e-01,
1.21550624639164186e-02,1.84611243243695887e-03,-1.37561946019118531e-02,-1.19694295496812798e-02,-1.19400824804688915e-02,6.28042332501056899e-01,-2.00735030334423560e-02,-8.92082101699930193e-03,-4.58217880274766343e-02,-4.40742679918432301e-01,-4.16179988761279207e-01,-2.13815597157913984e-01,-8.09840285758710865e-02,-1.69461599978818434e-01,-5.81635758440777861e-01,
1.21865607976978565e-02,1.64256718307659116e-03,-1.33530383853627567e-02,-1.44314014497067006e-02,-8.71739245567042242e-03,6.28483079992661064e-01,-2.78048082736548395e-03,-2.50734275409764534e-02,-7.81208427745734048e-03,-2.16110701947963176e-02,-8.07339220496105098e-02,-4.45488881796933855e-01,-5.22951200196615229e-01,-5.37107315370662031e-01,-2.56952772931864359e-01,
1.22159779690615162e-02,2.56259702246699594e-04,-1.40576363976068538e-02,-1.38103065036023851e-02,-9.95319628156404040e-03,6.28256299880567637e-01,-8.03119991484418372e-02,-2.14120689794397079e-01,-2.44007759063144120e-02,-4.64046260880134676e-01,-1.02585110484086806e-01,-4.64296617487854113e-01,-8.03901668598146213e-02,-6.00360891133989272e-01,-2.57760110453592095e-01,
1.22992913297866463e-02,-4.11013288678654498e-04,-1.28950440899242014e-02,-9.50049811235383415e-03,-9.20670246544842003e-03,6.28635471630376363e-01,-3.02061887884475799e-02,-1.87379240961575398e-02,-1.67873271367364255e-02,-3.59364234905200433e-02,-4.82709974248899831e-01,-4.68494945762212345e-01,-5.68892380632824768e-01,-1.72250480741395512e-01,-2.58080001038928197e-01,
1.23703407132735345e-02,-7.26536028250685494e-04,-1.54643498192046768e-02,-1.26722983993248547e-02,-1.22547158866876948e-02,6.27906308995064610e-01,-9.09661684415995486e-02,-1.96125090321202164e-02,-3.01107038822931682e-02,-4.70385352360688569e-01,-5.07502098846948524e-01,-4.69925307811296378e-01,-8.30547738392757723e-02,-1.73311029144888412e-01,-2.59371115502321614e-01,

8,15
8.84707992937081023e-01,1.05526651808219030e+00,1.42927336924552010e-02,1.62552478669013324e-02,1.92237592772310853e-02,1.06760426162797772e+00,1.19002575046792732e-02,1.21960600906422870e-02,9.05510080985245588e-03,3.68649550838547113e-01,4.14111624949819457e-01,4.44415660803929802e-01,1.08820255152336986e-03,4.23441610956972348e-03,1.51938166812131768e-02,
1.02029958137943066e+00,1.05617840909989158e+00,1.79029618655534954e-02,1.83275359891592916e-02,2.16426269213406963e-02,1.06830736487406419e+00,6.07287139082288239e-03,1.26170700970407376e-02,1.10001606921135107e-02,5.12674181208881488e-02,4.22931587014314048e-01,4.68362985563281153e-01,3.70350837068903482e-01,5.75237546452459381e-03,2.09659575333032491e-02,
1.13982278111406687e+00,1.05611624861869391e+00,1.74246502913777447e-02,2.21092414311341960e-02,2.00724502820081516e-02,1.14462169734842512e+00,1.56179618761032261e-02,8.33043143456495272e-03,1.36276806012569918e-02,4.41958756517210394e-01,1.07904189445084633e-01,4.78270603366069080e-01,1.98654954626392710e-03,4.22127397705469809e-01,2.93351863904284561e-02,
1.21634334326161775e+00,1.05575863736288733e+00,1.78384810777655264e-02,2.23212113501403166e-02,2.27416625655642093e-02,1.21818945569405468e+00,2.60527097707949386e-02,9.56260685944905139e-03,1.51396269460523751e-02,5.21775817929854974e-02,1.08576170758433913e-01,4.78129826055947338e-01,4.59978858256173684e-01,4.63304750335300108e-01,4.02306735679647670e-02,
1.22404723550856165e+00,1.05575352839782566e+00,1.78606194683984358e-02,1.67823270057378821e-02,2.17430833792134626e-02,1.22568980269163830e+00,2.14786853056334048e-02,1.39754625823929612e-02,1.85506723388340622e-02,4.63927878114044345e-01,4.78399643782373207e-01,1.63649741813603061e-01,2.62677671624161630e-03,1.05939584899345969e-02,4.70994002858664773e-01,
1.26412248961727802e+00,1.05538926190310178e+00,1.76390966078932079e-02,1.91172022388149156e-02,2.17821769993227707e-02,1.26437874931952465e+00,1.32646145768417767e-01,1.52436663670321680e-02,8.63633314566674137e-02,5.21903080421054558e-02,5.07461616829451900e-01,1.63944581679447254e-01,5.22943765705924823e-01,1.44107861730296861e-02,5.24272924471961943e-01,
1.28251761537597164e+00,1.05453319052217598e+00,1.94037613117270663e-02,2.22933564508671425e-02,2.24080101729607038e-02,1.28214446158494932e+00,5.70190629089021919e-02,4.31965428900353554e-02,1.49093407540431377e-01,4.69810811756051605e-01,1.09818719236646017e-01,1.65173998236213343e-01,4.83813633989648058e-03,5.46175053298188495e-01,5.61626336950449279e-01,
1.29084015887868842e+00,1.05331007784351538e+00,1.72114177605415183e-02,2.17485480435578617e-02,2.22284449528616056e-02,1.29012479855087103e+00,2.05323001560376905e+00,4.47562855791153069e+00,4.09740292883962742e-01,5.32163838402028092e-02,1.10755395883316538e-01,1.65762857481946746e-01,5.70817168376347661e-01,6.04313607244554962e-01,5.67565266207814445e-01,

