1
1
15
0
(8 0
((0,0,0) (7,7,7) (0,0,0))
((8,0,0) (15,7,7) (0,0,0))
((0,8,0) (7,15,7) (0,0,0))
((8,8,0) (15,15,7) (0,0,0))
((0,0,8) (7,7,15) (0,0,0))
((8,0,8) (15,7,15) (0,0,0))
((0,8,8) (7,15,15) (0,0,0))
((8,8,8) (15,15,15) (0,0,0))
)
8
FabOnDisk: Cell_D_00000 0
FabOnDisk: Cell_D_00000 61527
FabOnDisk: Cell_D_00000 123055
FabOnDisk: Cell_D_00000 184583
FabOnDisk: Cell_D_00000 246112
FabOnDisk: Cell_D_00000 307640
FabOnDisk: Cell_D_00000 369169
FabOnDisk: Cell_D_00000 430698

8,15
1.23160453935698914e-02,2.80491053528333124e-02,-1.31165224095508414e-02,-1.49573658711472449e-02,-8.94634014811592285e-03,6.28102229524539646e-01,-1.97055701759107612e-03,-5.00822733773002371e-04,-4.43627833962580132e-05,-9.85969707041397039e-03,-3.59654935647896537e-02,-1.02780383109510765e-01,-3.76656841360012262e-01,-4.30818590645405286e-01,-4.74845715096828713e-01,
1.21044197458787649e-02,1.14452715065279775e-02,-1.02249609215070945e-02,-1.47705213275567682e-02,-9.00540877731112639e-03,6.27922555848726027e-01,-9.83449672048590517e-03,-6.81613368138465317e-04,-5.41004274909074809e-03,-3.72751120548041437e-01,-4.60756696431267598e-02,-1.28741364017764898e-01,-7.41814888616256357e-02,-4.69793644294785762e-01,-5.27750109870391282e-01,
1.21195083345348939e-02,4.06513226969008098e-03,-1.37911546745906662e-02,-8.53506953524184320e-03,-8.80768289435982649e-03,6.28544388593817449e-01,-1.76674699078475375e-03,-8.30634721292198425e-03,-4.16516112309346376e-02,-1.64591779546478315e-02,-4.14429364968467051e-01,-1.61956812446010984e-01,-4.71503530560543560e-01,-1.63191990818878696e-01,-5.64131692270525176e-01,
1.21440005068535733e-02,1.58949235689166040e-03,-1.26883855283158493e-02,-1.08778037914313962e-02,-1.13921990761087118e-02,6.28048795626327649e-01,-2.37047993634771810e-02,-8.17022149269442874e-03,-4.13495892522310823e-02,-4.44013778504546874e-01,-4.20167460287936612e-01,-1.99170327294810351e-01,-7.77746458645166838e-02,-1.64375770214052308e-01,-5.72513024791058256e-01,
1.21732551395591516e-02,1.51066755707326039e-03,-1.29202662273583437e-02,-1.38323419101902753e-02,-7.73636429182642145e-03,6.28534526315784547e-01,-2.56078787034897011e-03,-2.66890275761104724e-02,-6.81120537745646525e-03,-2.09040793493662780e-02,-7.57383436019258005e-02,-4.47327862575678803e-01,-5.25894427821036903e-01,-5.43044457847757123e-01,-2.48423491608450259e-01,
1.22016696142617509e-02,1.74582391878270207e-04,-1.39599735607680020e-02,-1.31837985748145241e-02,-9.42982320797972756e-03,6.27893776824215433e-01,-9.91394018100382746e-02,-3.48479228953863351e-01,-2.57067626867509107e-02,-4.65599409823853505e-01,-9.56600968401043611e-02,-4.67975173882233086e-01,-7.71524746982273635e-02,-6.02313367020324675e-01,-2.48738449045732640e-01,
1.22798409483480808e-02,-4.08139271058757813e-04,-1.25706380163284129e-02,-9.99987241960286280e-03,-8.67786823549098786e-03,6.28045017397327765e-01,-2.77182497590801186e-02,-1.70081309102452262e-02,-1.38813483118773642e-02,-3.41797479435051593e-02,-4.80524863813853564e-01,-4.74636386377786934e-01,-5.66425289665985821e-01,-1.66416251884575261e-01,-2.49294497981036978e-01,
1.23480958551748943e-02,-7.20139711724303582e-04,-1.56135406030065444e-02,-1.29467142656266090e-02,-1.09953524884144338e-02,6.27036724729458150e-01,-7.23362790708439451e-02,-1.78890809198607031e-02,-2.73227651805991144e-02,-4.72071337920784428e-01,-5.07204854903781754e-01,-4.74320740277458186e-01,-7.98623263173414560e-02,-1.67212684540413159e-01,-2.50755986566748912e-01,

8,15
9.18993201543083726e-01,1.05533505058807608e+00,1.48414622852185846e-02,1.69745781035844853e-02,1.99525243796999825e-02,1.06765887287048922e+00,1.24427475913973518e-02,1.15244466857366123e-02,9.80000041788214177e-03,3.79229626834203803e-01,4.14591301552553970e-01,4.48931074691716614e-01,1.09598185020756082e-03,4.11746434005666028e-03,1.39959673262709354e-02,
1.04792810401790670e+00,1.05624926008622366e+00,1.76494556107187860e-02,1.82726830397661535e-02,2.21273396028835410e-02,1.06836953032252402e+00,6.56316087246051200e-03,1.21996806539708055e-02,1.25056952204452374e-02,4.91478110122190795e-02,4.18979117041637705e-01,4.68105699017943355e-01,3.78945411094044560e-01,5.56161075066669702e-03,1.91351845847062413e-02,
1.15518279625461129e+00,1.05614169860766882e+00,1.66946831469257304e-02,2.26641881567428705e-02,2.08228970686791526e-02,1.15924792852430136e+00,1.53961565123107141e-02,8.40642903214684940e-03,1.39476451620521077e-02,4.45807624829801519e-01,1.04550430320108773e-01,4.72604606213874456e-01,1.96732580506585363e-03,4.29859658609162976e-01,2.63560545923049901e-02,
1.22485014933730851e+00,1.05579510529745901e+00,1.82991847972534608e-02,2.28469165125949267e-02,2.32277562074245589e-02,1.22643964169420028e+00,3.03099023617294655e-02,9.49173676416617193e-03,1.58356667271693230e-02,5.03124542264991384e-02,1.04650768049033907e-01,4.72734589836535213e-01,4.67005415343700214e-01,4.70181528639776858e-01,3.57815298793015685e-02,
1.22845820987065446e+00,1.05577281421317570e+00,1.83729380202377265e-02,1.74944231882342323e-02,2.29659735872513385e-02,1.22996887742772776e+00,2.70692415704072258e-02,1.51246215247900460e-02,2.09911249809765915e-02,4.64075367276330752e-01,4.81848651062802003e-01,1.58525141320959267e-01,2.54154746975744465e-03,9.84336304300050847e-03,4.73117416114988365e-01,
1.26567740546243979e+00,1.05543006672100925e+00,1.76791288601458249e-02,2.03113410910193345e-02,2.28699858649855578e-02,1.26586891803593016e+00,1.73464619764680777e-01,1.64833932409300110e-02,1.54908971728671324e-01,5.02363849499349938e-02,5.08024465566788042e-01,1.58728703953440353e-01,5.24880541015724122e-01,1.32783142292047258e-02,5.27508870941773900e-01,
1.28302409468190581e+00,1.05460733161737163e+00,1.89605547681338284e-02,2.27200340194710429e-02,2.28774153707947542e-02,1.28263450814588231e+00,5.57316142736158718e-02,5.11976714887687478e-02,1.12467220879951063e-01,4.68005615282123255e-01,1.06078911520718314e-01,1.59669658434053563e-01,4.59503080676346154e-03,5.41881955833626305e-01,5.66896102493557374e-01,
1.29069033133827804e+00,1.05347939451110251e+00,1.66588094931286387e-02,2.22316583825821062e-02,2.25449588422312261e-02,1.28999408337421717e+00,3.00431316998528763e-01,5.36256506612078687e-01,2.59710374654540721e-01,5.16956111174025623e-02,1.06943915518844815e-01,1.60297258879784438e-01,5.73668395498253880e-01,6.01710358877171503e-01,5.76717930188410777e-01,

