1
1
15
0
(8 0
((0,0,0) (7,7,7) (0,0,0))
((8,0,0) (15,7,7) (0,0,0))
((0,8,0) (7,15,7) (0,0,0))
((8,8,0) (15,15,7) (0,0,0))
((0,0,8) (7,7,15) (0,0,0))
((8,0,8) (15,7,15) (0,0,0))
((0,8,8) (7,15,15) (0,0,0))
((8,8,8) (15,15,15) (0,0,0))
)
8
FabOnDisk: Cell_D_00000 0
FabOnDisk: Cell_D_00000 61527
FabOnDisk: Cell_D_00000 123055
FabOnDisk: Cell_D_00000 184583
FabOnDisk: Cell_D_00000 246112
FabOnDisk: Cell_D_00000 307640
FabOnDisk: Cell_D_00000 369169
FabOnDisk: Cell_D_00000 430698

8,15
1.22814868994067829e-02,1.96053822935743603e-02,-1.37997224599431048e-02,-1.40923138605718572e-02,-8.43458297799932165e-03,6.29218362076505833e-01,-2.05243395466307536e-03,-3.45462299687409268e-04,5.91260309416289276e-04,-9.93437381984679790e-03,-3.41635644702112384e-02,-9.26013394234995180e-02,-3.84607725349182084e-01,-4.41950166101944708e-01,-4.90360268505331931e-01,
1.20797210354053591e-02,7.80555029560285607e-03,-1.00787666610789445e-02,-1.40617170563277407e-02,-7.46317586117515967e-03,6.28927907735314262e-01,-9.54227814885488107e-03,-1.87849387166112822e-03,-1.50464601798518290e-02,-3.84137654122140904e-01,-4.34315891001509358e-02,-1.15509042482982494e-01,-7.03714146647775457e-02,-4.71972885060564673e-01,-5.33472985134485711e-01,
1.21027832273330836e-02,3.10925110002684482e-03,-1.36688666199032641e-02,-7.04825893965906839e-03,-8.17889655414162642e-03,6.29084517102551644e-01,-1.88430772405633984e-03,-6.47029018600839105e-03,-4.08801598241152891e-02,-1.60629469794225273e-02,-4.21392609113437733e-01,-1.43083595321155332e-01,-4.86462839255141222e-01,-1.52253505875719952e-01,-5.56255781458943610e-01,
1.21233110100596071e-02,1.20330550426378481e-03,-1.25532839354380258e-02,-9.13965263780757223e-03,-1.01418720056188731e-02,6.28102117192504750e-01,-3.16344978321805581e-02,-6.76339198085570189e-03,-3.55482211142905541e-02,-4.49295095347961360e-01,-4.27056115463974983e-01,-1.75784400594552193e-01,-7.27362477428771803e-02,-1.54182420553387961e-01,-5.58783458772475816e-01,
1.21502569846092430e-02,1.15687968830944284e-03,-1.20495319620367528e-02,-1.26274278414950907e-02,-6.45120828915715649e-03,6.28574915829221648e-01,-5.00819157153765612e-03,-2.40560376679430782e-02,-6.59272033871818874e-03,-2.00177178045845734e-02,-6.85612005155276094e-02,-4.49228925147744040e-01,-5.32744718013294594e-01,-5.56298324709634806e-01,-2.33116808762308336e-01,
1.21777690296637400e-02,-1.54618367251870302e-04,-1.44243717313729449e-02,-1.17086805373676564e-02,-8.67180463224548510e-03,6.27607970983926844e-01,-3.26001497248323280e-02,-6.87822476259094540e-01,-1.55050186540006601e-01,-4.68971434019757105e-01,-8.60308512994430452e-02,-4.72906693879798390e-01,-7.16527539215776749e-02,-6.07060235844541163e-01,-2.33824639259159778e-01,
1.22455175417642854e-02,-4.11625238099748295e-04,-1.25763503893960883e-02,-1.07792753062014596e-02,-7.46700534445338907e-03,6.27204871653030738e-01,-1.05136815475527057e-01,-1.53794294445545668e-02,-1.48916638563970277e-01,-3.17126785891559404e-02,-4.77807637373717231e-01,-4.84223571177506584e-01,-5.61469088119899484e-01,-1.56085326889109310e-01,-2.34670262652615508e-01,
1.23051839951784266e-02,-7.65253027265461292e-04,-1.67571454785854293e-02,-1.42607662782828822e-02,-1.00994760308083034e-02,6.27332232874820539e-01,-6.57730951809087222e-02,-1.78188612995694474e-02,-2.47284197824731503e-02,-4.74932369842260782e-01,-5.07009083657380955e-01,-4.84505880270115263e-01,-7.50798394375012668e-02,-1.56783636893073841e-01,-2.35910975565547187e-01,

8,15
9.74912194907514240e-01,1.05545704348038161e+00,1.51643753619544915e-02,1.82410394483729851e-02,2.12428696751222057e-02,1.06775617902257580e+00,1.24118163103856816e-02,9.72588418464400729e-03,1.16256663232666164e-02,3.95877975864209586e-01,4.12071228344196572e-01,4.52851450774354847e-01,1.10623065969526731e-03,3.90862006059362627e-03,1.21309451334721263e-02,
1.09142828361806465e+00,1.05633986359357257e+00,1.90996261353055877e-02,1.91351196088485886e-02,2.29484662637053291e-02,1.09923383391366758e+00,7.93605624811757719e-03,1.17551865682571782e-02,1.50095632508186454e-02,4.57297809783959869e-02,4.19503804488420728e-01,4.63672557932009177e-01,3.92849500730459822e-01,5.23590816319897002e-03,1.63879584307423110e-02,
1.17845941650683095e+00,1.05617810901196152e+00,1.75808553798821807e-02,2.32896059781459372e-02,2.21324354737045814e-02,1.18156866760685775e+00,1.41876056596518425e-02,8.49069031560458279e-03,1.42320413965306390e-02,4.50774609282178773e-01,9.78188072605063047e-02,4.63607853608062337e-01,1.92832688933809423e-03,4.42837861195860161e-01,2.18884245512339717e-02,
1.23743750499068073e+00,1.05584381412597383e+00,1.88780936968619313e-02,2.36303787483527379e-02,2.42775776922444439e-02,1.23864081049494446e+00,4.10377328316119394e-02,1.37745654009026088e-02,1.72558762313668387e-02,4.71956790875836529e-02,9.82574008883383004e-02,4.80786665008788194e-01,4.78503132164255440e-01,4.81854798197260070e-01,2.93728934060770858e-02,
1.23938128092486366e+00,1.05580474467490637e+00,1.95330471081577098e-02,1.97077732380498104e-02,2.52208473229976263e-02,1.24053816061317312e+00,5.05474202886775775e-02,1.69177938119308147e-02,2.36048297550150235e-02,4.63320098454259366e-01,4.88072877351135026e-01,1.48771758557548983e-01,2.44925074827921380e-03,8.84447019287855352e-03,4.75301604114131360e-01,
1.26982674138160601e+00,1.05548790050877628e+00,1.82309967056566921e-02,2.20633838181572700e-02,2.50010810221310206e-02,1.26967212301435417e+00,2.49763937253342450e-01,1.81578673130551281e-02,3.97184077235573779e-02,4.69605573380219021e-02,5.08152095317058405e-01,1.49472683898980413e-01,5.32224859025612007e-01,1.18079048617270033e-02,5.31430374136194095e-01,
1.28411205498196335e+00,1.05471679823700337e+00,2.07844739471931446e-02,2.32092746808849372e-02,2.39967238488450266e-02,1.28370042974386367e+00,6.22725866296418157e-02,1.20283045528083832e-01,6.99943982272926146e-02,4.75121984532050068e-01,9.95732491816880005e-02,1.50472357240010762e-01,4.28348118673904047e-03,5.37850080073924541e-01,5.73424460711770334e-01,
1.29115218214465211e+00,1.05374005438758611e+00,1.78485217098286221e-02,2.27565134581566852e-02,2.42086319797083921e-02,1.29043225090432001e+00,1.84433551729456524e-01,2.57471166067794188e-01,1.97431085995136035e-01,4.87951732580219691e-02,1.00472208630674367e-01,1.50914812911321583e-01,5.78523870534520035e-01,5.99546033851310334e-01,5.92248068983028064e-01,

