1
1
15
0
(8 0
((0,0,0) (7,7,7) (0,0,0))
((8,0,0) (15,7,7) (0,0,0))
((0,8,0) (7,15,7) (0,0,0))
((8,8,0) (15,15,7) (0,0,0))
((0,0,8) (7,7,15) (0,0,0))
((8,0,8) (15,7,15) (0,0,0))
((0,8,8) (7,15,15) (0,0,0))
((8,8,8) (15,15,15) (0,0,0))
)
8
FabOnDisk: Cell_D_00000 0
FabOnDisk: Cell_D_00000 61527
FabOnDisk: Cell_D_00000 123055
FabOnDisk: Cell_D_00000 184583
FabOnDisk: Cell_D_00000 246112
FabOnDisk: Cell_D_00000 307640
FabOnDisk: Cell_D_00000 369169
FabOnDisk: Cell_D_00000 430698

8,15
1.2283579111070390e-02,2.5622396031254553e-02,-1.3286628072361559e-02,-1.3630287793831051e-02,-7.0804311967732503e-03,6.2913172780777482e-01,-2.0247883924462604e-03,1.4862698452821930e-04,1.2682584635912760e-03,-9.9572749032351693e-03,-3.3132981571056000e-02,-1.0401536852543150e-01,-3.7899135475606288e-01,-4.3133869317435469e-01,-4.8153898636523335e-01,
1.2069907465612335e-02,1.0349928649908273e-02,-9.6226407185718496e-03,-1.3405417850050078e-02,-6.6438211324747476e-03,6.2819720600269391e-01,-1.0532861949238376e-02,2.5321935676386178e-04,-6.4272885859817342e-03,-3.7554866950419241e-01,-4.2366339086632489e-02,-1.2992534560164223e-01,-7.3172906210206348e-02,-4.6731272179267702e-01,-5.3269724431040011e-01,
1.2096151073103517e-02,4.0373854053599705e-03,-1.4125171649751122e-02,-7.6419041845151078e-03,-7.2856425480987228e-03,6.2831345852244769e-01,-1.5806226908840080e-03,-7.1395029416305104e-03,-4.0219181008356170e-02,-1.6260285340642406e-02,-4.1676524640312274e-01,-1.6089819679287426e-01,-4.7174416707946137e-01,-1.5538056091789570e-01,-5.6480226160217295e-01,
1.2118627279719133e-02,1.6297693679502118e-03,-1.2328321963135231e-02,-9.7389129332150111e-03,-1.0379251730495819e-02,6.2816136753548557e-01,-2.2227973280700870e-02,-6.9607474918233665e-03,-3.8909862295803961e-02,-4.4352773719827676e-01,-4.2507732414185817e-01,-1.9752384315936999e-01,-7.6268749069750674e-02,-1.5663671903788207e-01,-5.7312872006047055e-01,
1.2156973383479007e-02,1.3460216720429571e-03,-1.2625583758101249e-02,-1.2268452599389195e-02,-6.0280441920281778e-03,6.2951473532320656e-01,-2.4405031704704985e-03,-2.4606266104296573e-02,-5.7860658460924018e-03,-2.1124402061510301e-02,-7.0182799599375928e-02,-4.5027086125825072e-01,-5.2972753567843456e-01,-5.4953698970092490e-01,-2.4880128084907630e-01,
1.2182893743791175e-02,-8.9348608305030898e-05,-1.3539609768322478e-02,-1.1488780556059841e-02,-7.2870454777761483e-03,6.2825626909391930e-01,-5.3756586067332379e-01,-1.1860730853415780e+00,-1.0579969714297649e-01,-4.6685190246607366e-01,-8.8582005646633072e-02,-4.6996661996423322e-01,-7.5241117154991446e-02,-6.0449637161399261e-01,-2.4932525107877371e-01,
1.2257076504213862e-02,-4.0652686848340384e-04,-1.2436573599377080e-02,-9.4970352698513852e-03,-7.2006937729235387e-03,6.2736320151981628e-01,-2.6938003368874412e-02,-1.5616151271279393e-02,-1.8165096516596955e-02,-3.3865328940405705e-02,-4.7752583613405358e-01,-4.7578309046060108e-01,-5.6493430731383643e-01,-1.5935587365348797e-01,-2.5013626630313696e-01,
1.2319409984249156e-02,-7.2143941481485579e-04,-1.5759575634478891e-02,-1.3039377992440053e-02,-9.1189516045550069e-03,6.2627854986993337e-01,-4.2096132525030999e-02,-1.6713478016113441e-02,-2.8297325077557979e-02,-4.7240140592105828e-01,-5.0665912734436558e-01,-4.7541005235730949e-01,-7.8690384180713446e-02,-1.6046632652097798e-01,-2.5195596320630897e-01,

8,15
9.3346697951096513e-01,1.0554699451919061e+00,1.5093891538836009e-02,1.7866214478323015e-02,2.1841815627926326e-02,1.0677640026702249e+00,1.3347458126685013e-02,1.2214695117185358e-02,1.1286241248207159e-02,3.8377862464654688e-01,4.1203106266136491e-01,4.5218561288998599e-01,1.1075620477565599e-03,3.7775084991227368e-03,1.4163866745782017e-02,
1.0594652543838696e+00,1.0563692870950911e+00,1.8886221106114140e-02,1.9827264802134086e-02,2.3142915989981000e-02,1.0698151830337779e+00,6.8319442796336881e-03,1.3158954522662374e-02,1.4262779668902877e-02,4.7968794910072471e-02,4.1371024724684868e-01,4.6996502763025855e-01,3.8233603328229676e-01,5.0865520723602335e-03,1.9299489987109800e-02,
1.1558518320261952e+00,1.0562122322414098e+00,1.7384406086483686e-02,2.4266977070675787e-02,2.2309029162445874e-02,1.1598892174315552e+00,1.5812483725208971e-02,8.1450481092770390e-03,1.4999108273400445e-02,4.4578166906110062e-01,9.9682621750721526e-02,4.7354091255414565e-01,1.9439334487064066e-03,4.2979209915826799e-01,2.6003573038872317e-02,
1.2249250068541035e+00,1.0558790606349167e+00,1.9611515580610861e-02,2.4375243658940803e-02,2.4793933664687316e-02,1.2265547762220537e+00,2.9443972745167187e-02,1.5276000694415240e-02,1.7263327474792440e-02,4.9652363467099170e-02,9.9854036429882082e-02,4.7338169185006829e-01,4.6596217357352288e-01,4.7227231500808831e-01,3.5183576806325570e-02,
1.2341275329613743e+00,1.0557971022334562e+00,1.8860284056121761e-02,1.8703460976412997e-02,2.5349185759380315e-02,1.2354735546334172e+00,4.1915108232284240e-02,1.6896174956501506e-02,2.5284677752408863e-02,4.6434255845846112e-01,4.8514268155074874e-01,1.5892716235158438e-01,2.5752558535698097e-03,9.0375704899337498e-03,4.7930586464463226e-01,
1.2684292398688917e+00,1.0554482567690944e+00,1.8946458436428996e-02,2.1502361407321431e-02,2.5278864244398225e-02,1.2683398912605865e+00,4.7465122827404338e-01,1.8547924144170062e-02,6.2475997159691310e-01,4.9357433577556245e-02,5.0792750575948475e-01,1.5928594408777463e-01,5.2886146606733042e-01,1.2150954123407063e-02,5.3238411359122972e-01,
1.2832449945490583e+00,1.0546689175586341e+00,1.9788857545423977e-02,2.3937384580426678e-02,2.4308760324393622e-02,1.2828640997717529e+00,5.8542400752087220e-02,9.7133879207134885e-02,1.5782848737279603e-01,4.6945253104835161e-01,1.0173178116995643e-01,1.6038078744002471e-01,4.5526044561023261e-03,5.3657428696455733e-01,5.6834942424555923e-01,
1.2908117473431586e+00,1.0536043060323215e+00,1.7544804532134632e-02,2.3442902777975796e-02,2.4130823996422232e-02,1.2901216442579442e+00,1.8948169561879999e-01,3.0411422537878385e-01,1.9021338381110636e-01,5.1297997037981893e-02,1.0285355248611790e-01,1.6095438856927480e-01,5.7426874024492991e-01,5.9899496051693524e-01,5.7837352429743216e-01,

