1
1
15
0
(8 0
((0,0,0) (7,7,7) (0,0,0))
((8,0,0) (15,7,7) (0,0,0))
((0,8,0) (7,15,7) (0,0,0))
((8,8,0) (15,15,7) (0,0,0))
((0,0,8) (7,7,15) (0,0,0))
((8,0,8) (15,7,15) (0,0,0))
((0,8,8) (7,15,15) (0,0,0))
((8,8,8) (15,15,15) (0,0,0))
)
8
FabOnDisk: Cell_D_00000 0
FabOnDisk: Cell_D_00000 61527
FabOnDisk: Cell_D_00000 123055
FabOnDisk: Cell_D_00000 184583
FabOnDisk: Cell_D_00000 246112
FabOnDisk: Cell_D_00000 307640
FabOnDisk: Cell_D_00000 369169
FabOnDisk: Cell_D_00000 430698

8,15
1.22835791110703901e-02,2.56223960312545532e-02,-1.32866280723615594e-02,-1.36302877938310509e-02,-7.08043119677325035e-03,6.29131727807774821e-01,-2.02478839244626041e-03,1.48626984528219295e-04,1.26825846359127602e-03,-9.95727490323516928e-03,-3.31329815710559999e-02,-1.04015368525431501e-01,-3.78991354756062881e-01,-4.31338693174354693e-01,-4.81538986365233346e-01,
1.20699074656123347e-02,1.03499286499082726e-02,-9.62264071857184961e-03,-1.34054178500500783e-02,-6.64382113247474759e-03,6.28197206002693909e-01,-1.05328619492383764e-02,2.53219356763861782e-04,-6.42728858598173424e-03,-3.75548669504192412e-01,-4.23663390866324888e-02,-1.29925345601642234e-01,-7.31729062102063482e-02,-4.67312721792677022e-01,-5.32697244310400109e-01,
1.20961510731035175e-02,4.03738540535997052e-03,-1.41251716497511216e-02,-7.64190418451510776e-03,-7.28564254809872282e-03,6.28313458522447688e-01,-1.58062269088400805e-03,-7.13950294163051037e-03,-4.02191810083561696e-02,-1.62602853406424060e-02,-4.16765246403122736e-01,-1.60898196792874260e-01,-4.71744167079461374e-01,-1.55380560917895705e-01,-5.64802261602172950e-01,
1.21186272797191331e-02,1.62976936795021185e-03,-1.23283219631352310e-02,-9.73891293321501109e-03,-1.03792517304958191e-02,6.28161367535485571e-01,-2.22279732807008704e-02,-6.96074749182336652e-03,-3.89098622958039611e-02,-4.43527737198276761e-01,-4.25077324141858170e-01,-1.97523843159369994e-01,-7.62687490697506743e-02,-1.56636719037882066e-01,-5.73128720060470553e-01,
1.21569733834790070e-02,1.34602167204295707e-03,-1.26255837581012494e-02,-1.22684525993891954e-02,-6.02804419202817784e-03,6.29514735323206565e-01,-2.44050317047049851e-03,-2.46062661042965730e-02,-5.78606584609240183e-03,-2.11244020615103008e-02,-7.01827995993759279e-02,-4.50270861258250721e-01,-5.29727535678434558e-01,-5.49536989700924905e-01,-2.48801280849076295e-01,
1.21828937437911747e-02,-8.93486083050308984e-05,-1.35396097683224779e-02,-1.14887805560598411e-02,-7.28704547777614831e-03,6.28256269093919295e-01,-5.37565860673323792e-01,-1.18607308534157796e+00,-1.05799697142976490e-01,-4.66851902466073665e-01,-8.85820056466330719e-02,-4.69966619964233223e-01,-7.52411171549914465e-02,-6.04496371613992611e-01,-2.49325251078773708e-01,
1.22570765042138621e-02,-4.06526868483403836e-04,-1.24365735993770803e-02,-9.49703526985138519e-03,-7.20069377292353874e-03,6.27363201519816283e-01,-2.69380033688744122e-02,-1.56161512712793930e-02,-1.81650965165969548e-02,-3.38653289404057048e-02,-4.77525836134053583e-01,-4.75783090460601077e-01,-5.64934307313836426e-01,-1.59355873653487967e-01,-2.50136266303136956e-01,
1.23194099842491561e-02,-7.21439414814855793e-04,-1.57595756344788909e-02,-1.30393779924400533e-02,-9.11895160455500689e-03,6.26278549869933365e-01,-4.20961325250309992e-02,-1.67134780161134408e-02,-2.82973250775579790e-02,-4.72401405921058282e-01,-5.06659127344365579e-01,-4.75410052357309487e-01,-7.86903841807134463e-02,-1.60466326520977975e-01,-2.51955963206308975e-01,

8,15
9.33466979510965134e-01,1.05546994519190607e+00,1.50938915388360087e-02,1.78662144783230149e-02,2.18418156279263261e-02,1.06776400267022487e+00,1.33474581266850127e-02,1.22146951171853580e-02,1.12862412482071586e-02,3.83778624646546884e-01,4.12031062661364911e-01,4.52185612889985988e-01,1.10756204775655986e-03,3.77750849912273680e-03,1.41638667457820167e-02,
1.05946525438386963e+00,1.05636928709509115e+00,1.88862211061141400e-02,1.98272648021340855e-02,2.31429159899810000e-02,1.06981518303377787e+00,6.83194427963368812e-03,1.31589545226623739e-02,1.42627796689028773e-02,4.79687949100724709e-02,4.13710247246848684e-01,4.69965027630258547e-01,3.82336033282296761e-01,5.08655207236023352e-03,1.92994899871097997e-02,
1.15585183202619524e+00,1.05621223224140981e+00,1.73844060864836863e-02,2.42669770706757867e-02,2.23090291624458738e-02,1.15988921743155515e+00,1.58124837252089714e-02,8.14504810927703903e-03,1.49991082734004452e-02,4.45781669061100616e-01,9.96826217507215256e-02,4.73540912554145654e-01,1.94393344870640657e-03,4.29792099158267993e-01,2.60035730388723171e-02,
1.22492500685410355e+00,1.05587906063491666e+00,1.96115155806108610e-02,2.43752436589408025e-02,2.47939336646873162e-02,1.22655477622205367e+00,2.94439727451671872e-02,1.52760006944152402e-02,1.72633274747924399e-02,4.96523634670991698e-02,9.98540364298820815e-02,4.73381691850068287e-01,4.65962173573522875e-01,4.72272315008088306e-01,3.51835768063255699e-02,
1.23412753296137434e+00,1.05579710223345624e+00,1.88602840561217615e-02,1.87034609764129972e-02,2.53491857593803153e-02,1.23547355463341724e+00,4.19151082322842400e-02,1.68961749565015064e-02,2.52846777524088628e-02,4.64342558458461119e-01,4.85142681550748744e-01,1.58927162351584383e-01,2.57525585356980970e-03,9.03757048993374980e-03,4.79305864644632262e-01,
1.26842923986889167e+00,1.05544825676909437e+00,1.89464584364289965e-02,2.15023614073214311e-02,2.52788642443982255e-02,1.26833989126058655e+00,4.74651228274043380e-01,1.85479241441700617e-02,6.24759971596913100e-01,4.93574335775562451e-02,5.07927505759484754e-01,1.59285944087774634e-01,5.28861466067330421e-01,1.21509541234070626e-02,5.32384113591229724e-01,
1.28324499454905827e+00,1.05466891755863412e+00,1.97888575454239768e-02,2.39373845804266780e-02,2.43087603243936218e-02,1.28286409977175286e+00,5.85424007520872203e-02,9.71338792071348850e-02,1.57828487372796034e-01,4.69452531048351607e-01,1.01731781169956431e-01,1.60380787440024708e-01,4.55260445610232607e-03,5.36574286964557334e-01,5.68349424245559232e-01,
1.29081174734315862e+00,1.05360430603232147e+00,1.75448045321346321e-02,2.34429027779757965e-02,2.41308239964222321e-02,1.29012164425794418e+00,1.89481695618799989e-01,3.04114225378783853e-01,1.90213383811106362e-01,5.12979970379818934e-02,1.02853552486117897e-01,1.60954388569274798e-01,5.74268740244929909e-01,5.98994960516935238e-01,5.78373524297432162e-01,

