1
1
15
0
(8 0
((0,0,0) (7,7,7) (0,0,0))
((8,0,0) (15,7,7) (0,0,0))
((0,8,0) (7,15,7) (0,0,0))
((8,8,0) (15,15,7) (0,0,0))
((0,0,8) (7,7,15) (0,0,0))
((8,0,8) (15,7,15) (0,0,0))
((0,8,8) (7,15,15) (0,0,0))
((8,8,8) (15,15,15) (0,0,0))
)
8
FabOnDisk: Cell_D_00000 0
FabOnDisk: Cell_D_00000 61527
FabOnDisk: Cell_D_00000 123055
FabOnDisk: Cell_D_00000 184583
FabOnDisk: Cell_D_00000 246112
FabOnDisk: Cell_D_00000 307640
FabOnDisk: Cell_D_00000 369169
FabOnDisk: Cell_D_00000 430698

8,15
1.22853981744229859e-02,2.37693550162881261e-02,-1.35676963140140532e-02,-1.35305896279563718e-02,-7.45053816670223322e-03,6.28797180074624151e-01,-2.03310237828100262e-03,1.36435866411085147e-04,1.17888861109169104e-03,-1.02248220749581731e-02,-3.26706180776726099e-02,-1.01076942784346313e-01,-3.81751049548849419e-01,-4.33389276143425151e-01,-4.84726817470431781e-01,
1.20728552196988741e-02,9.47984219963260433e-03,-9.71924179268435738e-03,-1.33445178622051373e-02,-6.80680261661796397e-03,6.28931564851002101e-01,-1.00527376963833910e-02,1.47654709019242616e-04,-9.82835344963125038e-03,-3.79453571015669122e-01,-4.18133344550276759e-02,-1.26441989675698752e-01,-7.38400963299932489e-02,-4.67567478383377422e-01,-5.34095821832592854e-01,
1.20973032348101212e-02,3.82648278804980204e-03,-1.41235889874366128e-02,-7.66403092496437642e-03,-7.57705891834505388e-03,6.28353938214237462e-01,-1.54972712895358878e-03,-6.76919021515873069e-03,-4.04667507056734599e-02,-1.65822092203120053e-02,-4.18203187281432354e-01,-1.55508938653652534e-01,-4.74996999001856435e-01,-1.52764224205901328e-01,-5.62885377932113684e-01,
1.21197884096858142e-02,1.50222436485455209e-03,-1.19903643082244268e-02,-9.29721882471870077e-03,-1.02096529144192344e-02,6.28148464782955385e-01,-2.39199261582631675e-02,-6.64459572752768533e-03,-3.66293018501196374e-02,-4.45171014756763128e-01,-4.26592735770255027e-01,-1.91325396444606277e-01,-7.66887591921511930e-02,-1.54239146514121656e-01,-5.69990166532368336e-01,
1.21566000732422595e-02,1.28809076748475542e-03,-1.26305061762613594e-02,-1.21065383033880057e-02,-5.92306331483939078e-03,6.29362322029198951e-01,-2.96300919149032442e-03,-2.30445603543567856e-02,-5.83049707844773748e-03,-2.13374080395770833e-02,-6.79906469827468996e-02,-4.50506129086966134e-01,-5.31597315513581692e-01,-5.51872265162072551e-01,-2.45088189518260530e-01,
1.21826798374583874e-02,-3.59999407420777081e-05,-1.41397994406014700e-02,-1.13284180479027267e-02,-7.73435244166723219e-03,6.28188016018692674e-01,-6.73395793553606015e-01,-2.39275205730411443e+02,-9.05475887986389137e-03,-4.67305697554627586e-01,-8.59271311926414066e-02,-4.71311413298726445e-01,-7.54829732548377291e-02,-6.05218656744952455e-01,-2.45624060527002863e-01,
1.22534458393581021e-02,-4.02873454913242157e-04,-1.25554468357562676e-02,-9.69563190936012682e-03,-7.12044804376641902e-03,6.27095269982918646e-01,-2.62069851916247390e-02,-1.53874807182544371e-02,-2.32052032533868538e-02,-3.39753328466924076e-02,-4.75532964308286232e-01,-4.78369276405896660e-01,-5.65316856946634028e-01,-1.56521170764020001e-01,-2.46158814289976352e-01,
1.23151136016838199e-02,-7.17731615264621142e-04,-1.60823222214368858e-02,-1.32034099647901706e-02,-9.23026259513141933e-03,6.26228341004096301e-01,-4.38713295221880017e-02,-1.65394383875806794e-02,-2.74888322369262889e-02,-4.72068149222790168e-01,-5.05922651635883791e-01,-4.77931196013542392e-01,-7.91786889099374419e-02,-1.57889735818387000e-01,-2.47996623074136002e-01,

8,15
9.45539792165596915e-01,1.05546529982204351e+00,1.51320006735438176e-02,1.76820304733027525e-02,2.17123560032823591e-02,1.06776253295613488e+00,1.31492318891774877e-02,1.17854197067090629e-02,1.13741522779100650e-02,3.87114887137780805e-01,4.11160426398654189e-01,4.52978145182993730e-01,1.13856105878265600e-03,3.72301394394030857e-03,1.36148035047612016e-02,
1.06988015021649763e+00,1.05636763397209466e+00,1.91642386784583764e-02,1.95953345486653101e-02,2.31413362675747872e-02,1.07935999241613034e+00,7.16617813412240637e-03,1.28325053936882739e-02,1.46388080766100027e-02,4.82046434092615605e-02,4.11194284324901016e-01,4.68982354394960999e-01,3.85160901812998113e-01,5.01833554106104023e-03,1.85553463817781303e-02,
1.16069833880455731e+00,1.05621068626470627e+00,1.72868519460339064e-02,2.43294294982003591e-02,2.21795773197264144e-02,1.16452482159260717e+00,1.54984203193465550e-02,8.22963595014221394e-03,1.49886826604790826e-02,4.47118145488781371e-01,9.81059145940719468e-02,4.71493521372665703e-01,1.98477926244382610e-03,4.32330162480575209e-01,2.47053802568106169e-02,
1.22805741495578880e+00,1.05587319741816610e+00,1.96318240748770481e-02,2.44466387461529482e-02,2.46577240511960914e-02,1.22955963932064338e+00,3.28838635385833716e-02,9.51178216104484574e-03,1.72854642302986104e-02,4.99618682320923796e-02,9.83779764300815179e-02,4.70906061296805345e-01,4.69790862095671891e-01,4.74958954821775858e-01,3.34405938405028663e-02,
1.23603940131814216e+00,1.05580165328104725e+00,1.93094424831564103e-02,1.90248378415257477e-02,2.54391142724828372e-02,1.23732749208562698e+00,4.30913978563366093e-02,1.72952513848312443e-02,2.88551701782112646e-02,4.64831136286754321e-01,4.86116735471574080e-01,1.56485418489331257e-01,2.60483428576360927e-03,8.71863294275598832e-03,4.79122377272497624e-01,
1.26906587881275912e+00,1.05545245777564434e+00,1.89817639127942556e-02,2.15518479851812828e-02,2.53841013933638268e-02,1.26906616472793954e+00,1.03964942305236335e+02,1.88711779129661535e-02,1.27693512736371645e+02,4.95151480132891078e-02,5.07643662844138532e-01,1.56958197657591836e-01,5.30902162962524238e-01,1.17300094853266621e-02,5.33369233423901301e-01,
1.28348380341759705e+00,1.05469932384776310e+00,2.01609697330498369e-02,2.40196229081416635e-02,2.44800310040090563e-02,1.28309379215918673e+00,6.07443518366541785e-02,8.40532926319738083e-02,1.16446425692444414e-01,4.69564233440345480e-01,9.98991516475155744e-02,1.57877720792007514e-01,4.56329348821345182e-03,5.33268282347453715e-01,5.69712582024373027e-01,
1.29098773054732274e+00,1.05364711101564246e+00,1.78219857353163064e-02,2.34970094476009972e-02,2.42541639883801716e-02,1.29028600380291958e+00,1.50661032289057140e-01,2.25811805470391758e-01,1.73364762429234376e-01,5.16183659132216782e-02,1.01156549923775929e-01,1.58485780456787212e-01,5.73776250834866053e-01,5.97176908391393146e-01,5.82527955290382815e-01,

