1
1
15
0
(8 0
((0,0,0) (7,7,7) (0,0,0))
((8,0,0) (15,7,7) (0,0,0))
((0,8,0) (7,15,7) (0,0,0))
((8,8,0) (15,15,7) (0,0,0))
((0,0,8) (7,7,15) (0,0,0))
((8,0,8) (15,7,15) (0,0,0))
((0,8,8) (7,15,15) (0,0,0))
((8,8,8) (15,15,15) (0,0,0))
)
8
FabOnDisk: Cell_D_00000 0
FabOnDisk: Cell_D_00000 61527
FabOnDisk: Cell_D_00000 123055
FabOnDisk: Cell_D_00000 184583
FabOnDisk: Cell_D_00000 246112
FabOnDisk: Cell_D_00000 307640
FabOnDisk: Cell_D_00000 369169
FabOnDisk: Cell_D_00000 430698

8,15
1.22676781740199709e-02,1.70965062783843928e-02,-1.40420398229408432e-02,-1.36516262105569781e-02,-8.36565243839911508e-03,6.28373837031479976e-01,-2.08159642726587005e-03,-4.21186352746000421e-04,8.81372388771842685e-04,-9.93978674721901490e-03,-3.34761365522627946e-02,-8.89191355732575350e-02,-3.86670232258744195e-01,-4.44910050510453292e-01,-4.94836620241670855e-01,
1.20664467743214106e-02,6.78097993030073263e-03,-9.94505824456646398e-03,-1.37111239640186604e-02,-7.29205287705753449e-03,6.28814860300390577e-01,-9.24166235639612560e-03,-5.17327456387879549e-03,-1.85668688463660123e-02,-3.88218806925395454e-01,-4.24335773222396379e-02,-1.10733503016010065e-01,-6.87257021135544155e-02,-4.71434864307826385e-01,-5.34093544087117733e-01,
1.20941888798324435e-02,2.82974870825087503e-03,-1.35736409455990571e-02,-6.71553657991201709e-03,-7.93790598279621798e-03,6.28931395849688490e-01,-1.88615895556594818e-03,-5.68861693321456342e-03,-3.96019372219783977e-02,-1.58844323122830540e-02,-4.23922028624187153e-01,-1.36359867682119024e-01,-4.91346717109533371e-01,-1.47809905626926419e-01,-5.52236818790316608e-01,
1.21147815582507094e-02,1.07001271012627697e-03,-1.27301224447379496e-02,-9.12567367315792605e-03,-9.50328309965005683e-03,6.28131432400305556e-01,-3.55020026666930388e-02,-6.99631000183986544e-03,-3.43049719665165925e-02,-4.51155382003288363e-01,-4.29603835432691428e-01,-1.67433135583743203e-01,-7.08359802820723444e-02,-1.50121148129712445e-01,-5.61729558396751760e-01,
1.21413334602573052e-02,1.06416889964586420e-03,-1.18910448375119052e-02,-1.20385282534477295e-02,-5.92185690126474044e-03,6.28583870758857799e-01,-6.48480176981841832e-03,-2.16533877566528685e-02,-6.35893921128717100e-03,-1.97111496394778048e-02,-6.61207754343210441e-02,-4.49506794983349167e-01,-5.34705770056733032e-01,-5.60476190637668625e-01,-2.27040900340704815e-01,
1.21652019066563737e-02,-4.84992357360733528e-05,-1.42864237136812768e-02,-1.10510540189529792e-02,-8.23543579357806886e-03,6.27634430298231516e-01,-2.83086641495859589e-02,-1.42505361283305776e+00,-3.29180520035824153e-02,-4.70172230658863877e-01,-8.27751706636871837e-02,-4.74248194434866988e-01,-6.96703627942640014e-02,-6.08087901493080896e-01,-2.28111182806043838e-01,
1.22329203863244616e-02,-4.16490006413897562e-04,-1.25389010777621039e-02,-1.09497400293617989e-02,-6.97298093515145642e-03,6.27731847916224606e-01,-2.89099397579505799e-02,-1.48351358765294473e-02,-2.78575535584626964e-02,-3.08799027480716540e-02,-4.76722759107297445e-01,-4.87047888943207052e-01,-5.59260070029981016e-01,-1.52162228706028746e-01,-2.29652485722863453e-01,
1.22888454550667322e-02,-7.79039641914679214e-04,-1.70947524606261773e-02,-1.46155785876056835e-02,-9.66988346136378463e-03,6.28828801185255193e-01,-6.18080652712384784e-02,-1.78605970787703780e-02,-2.38651744983592595e-02,-4.75992969486994488e-01,-5.06696238051975723e-01,-4.88560237524136576e-01,-7.36046044357961393e-02,-1.52896904857307031e-01,-2.30400476905692125e-01,

8,15
9.94474455519250622e-01,1.05551913104540995e+00,1.53793494615104814e-02,1.86928748858263619e-02,2.16124527241965056e-02,1.06780525792230896e+00,1.22518143522509278e-02,1.02764935699229554e-02,1.22244855359558736e-02,4.01526156130280587e-01,4.10067607698763104e-01,4.53032725023424565e-01,1.10944417750769996e-03,3.83067353478742803e-03,1.14990078845006814e-02,
1.10617359934604442e+00,1.05637922432515885e+00,1.95006716181968034e-02,1.98013485593622508e-02,2.34241515387103166e-02,1.11295457927634511e+00,8.72928599029026107e-03,1.21090520417351348e-02,1.58217076115804399e-02,4.44607430892877478e-02,4.26382223483562584e-01,4.60758376903324773e-01,3.97684136042010972e-01,5.11447217230240770e-03,1.54667333279438161e-02,
1.18615986388995154e+00,1.05618084362449238e+00,1.79378577711111487e-02,2.33738403719528989e-02,2.24275225984371246e-02,1.18898961259820246e+00,1.47798340262708383e-02,8.57593354882136248e-03,1.42272597214472447e-02,4.52087375218386156e-01,9.50730626172462123e-02,4.59298262048165706e-01,1.91199420755543332e-03,4.47497616536034259e-01,2.04234495184745617e-02,
1.24146230701521598e+00,1.05585052215820729e+00,1.90347766502290613e-02,2.38515760893852694e-02,2.46036843069511423e-02,1.24253231972534217e+00,4.61242556089682815e-02,1.75292274636070014e-02,1.77837642461051298e-02,4.60367261193486491e-02,9.57268480556582313e-02,4.86210976279007001e-01,4.82552967169657399e-01,4.86063750233379332e-01,2.72884783006970208e-02,
1.24281682822711592e+00,1.05583637664369201e+00,1.97277388971293967e-02,2.03746580110361203e-02,2.60323206246955430e-02,1.24388099712676170e+00,4.21516776457835016e-02,1.75457312869791958e-02,2.48692868553501006e-02,4.62634262545118358e-01,4.89734644276368924e-01,1.45276825447686414e-01,2.41749699378915068e-03,8.51086675615504197e-03,4.75568806342314743e-01,
1.27153908078535016e+00,1.05550466083927108e+00,1.83737871741325061e-02,2.26596150233953492e-02,2.57397187407366924e-02,1.27149058154961403e+00,4.75554879294635580e-01,1.96965359380542257e-02,5.39794801327313500e-02,4.58409150980973526e-02,5.07567086222081798e-01,1.45965360092871005e-01,5.34823743164846155e-01,1.13192502172094079e-02,5.32304320900865324e-01,
1.28449201875481100e+00,1.05477555410313739e+00,2.13393450361412107e-02,2.33739373075630835e-02,2.47328621675257099e-02,1.28407552874839714e+00,6.30115696024071414e-02,4.97444619046453484e-02,6.00494666460260618e-02,4.77610748628515602e-01,9.71449259930035197e-02,1.46963179526820531e-01,4.17612989018301475e-03,5.36329822742339868e-01,5.74966600415111939e-01,
1.29127189388714148e+00,1.05381853361277211e+00,1.82715728289024187e-02,2.28645108147120558e-02,2.49954446855969875e-02,1.29054658224409247e+00,1.74200438496302318e-01,2.27688576931493469e-01,1.81351468901444657e-01,4.76877709567711666e-02,9.82267202498750686e-02,1.47437197817868487e-01,5.80293532119918298e-01,5.98554577720731729e-01,5.96975498367663726e-01,

