1
1
15
0
(8 0
((0,0,0) (7,7,7) (0,0,0))
((8,0,0) (15,7,7) (0,0,0))
((0,8,0) (7,15,7) (0,0,0))
((8,8,0) (15,15,7) (0,0,0))
((0,0,8) (7,7,15) (0,0,0))
((8,0,8) (15,7,15) (0,0,0))
((0,8,8) (7,15,15) (0,0,0))
((8,8,8) (15,15,15) (0,0,0))
)
8
FabOnDisk: Cell_D_00000 0
FabOnDisk: Cell_D_00000 61527
FabOnDisk: Cell_D_00000 123055
FabOnDisk: Cell_D_00000 184583
FabOnDisk: Cell_D_00000 246112
FabOnDisk: Cell_D_00000 307640
FabOnDisk: Cell_D_00000 369169
FabOnDisk: Cell_D_00000 430698

8,15
1.1752210526115095e-02,5.1172133091687251e-03,-1.4440040305254582e-02,-7.8642846024597115e-03,-6.7357939121770304e-03,6.2655188014359253e-01,-1.8944081178410453e-03,-1.0094366025432266e-02,-2.0505557066796666e-02,-1.0440273463096450e-02,-2.6592248276720833e-02,-6.2424321918154849e-02,-4.5668004352548330e-01,-4.6139366727407399e-01,-5.0190021170007038e-01,
1.1563486847239436e-02,2.2569016439639936e-03,-8.1162139609225713e-03,-9.5835468121696389e-03,-5.0338499290498231e-03,6.3174796490949547e-01,-1.9332640703723963e-02,-1.2041674605728390e-02,-2.2142817186015254e-02,-4.2282034243940347e-01,-3.2723238894155959e-02,-7.5991925694140067e-02,-5.1155297621699715e-02,-5.1314662635102493e-01,-5.1659760275453925e-01,
1.1653187734170650e-02,1.4622488595769428e-03,-1.2972957033503317e-02,-2.9613663339591138e-03,-4.1618504238529041e-03,6.2933239481805026e-01,-1.8290623982276967e-03,-6.7769493812257766e-03,-1.6741831255824621e-02,-1.4684386452002577e-02,-4.4412500139898203e-01,-8.6877760287901284e-02,-5.1652513341195072e-01,-1.0595927802467449e-01,-5.5109430445475360e-01,
1.1614857807740063e-02,3.0173592323031216e-04,-1.1363206566160685e-02,-5.3763041110843467e-03,-7.1759951096856834e-03,6.2794352003822551e-01,-6.9756310680989850e-02,-4.9134319393555934e-02,-2.0600549138517926e-01,-4.6381357643691623e-01,-4.5172854444476396e-01,-1.0516851144167999e-01,-5.3278351378226188e-02,-1.0905957724260895e-01,-6.0392461621163307e-01,
1.1699990473112393e-02,3.7541604346571719e-04,-1.3635959545224346e-02,-7.0211908389380354e-03,-1.0498489085011640e-03,6.2857440172773504e-01,-1.3480522484340011e-02,-3.6570898964717435e-02,-9.4612289487623277e-04,-1.7557971943782225e-02,-4.5164715582953430e-02,-4.4482783424028682e-01,-5.3656219937233351e-01,-5.7578127798789125e-01,-1.7639559982850597e-01,
1.1674283856708486e-02,-2.9820583359165529e-04,-9.9667650738404431e-03,-1.3897395715266981e-02,-1.3613478463479259e-03,6.2981411347016891e-01,-9.6873900363979248e-02,-2.4126290133489364e-01,-6.6523049809503456e-04,-4.7831341767271063e-01,-5.5200630184980351e-02,-4.7597448222273753e-01,-5.3465220818135664e-02,-5.9331087233866497e-01,-1.7370920108142057e-01,
1.1787666305011154e-02,-3.5883492758083179e-04,-1.1786935632738662e-02,-6.9321797240793001e-03,-8.6407277545844617e-04,6.2692838897852554e-01,-2.4817935349103003e-02,-1.0851172016657615e-02,-1.7740501978956505e-02,-2.4558328161757143e-02,-4.5639324772704831e-01,-4.9348588422470213e-01,-5.7531169987150799e-01,-1.1226820423095087e-01,-1.8077541868775074e-01,
1.1756719989104190e-02,-7.9568547051898854e-04,-1.4535270329000569e-02,-1.2594921693304945e-02,-3.3606540251109682e-03,6.2505952969598744e-01,-2.3306419523296078e-02,-4.9566582997929258e-02,-2.1956883892208429e-02,-4.8289376824679775e-01,-4.9208799620718652e-01,-5.1144925891038551e-01,-5.7943477610586963e-02,-1.1455606887416554e-01,-1.8242066172979890e-01,

8,15
1.1361839197256094e+00,1.0576169698271849e+00,1.7557306144346019e-02,2.2307609688227068e-02,2.8215591070833435e-02,1.1413011330347782e+00,1.3675274305027997e-02,1.4993416927395056e-02,1.9134459317240591e-02,4.3664998823064327e-01,4.4463951045309447e-01,4.3566704765126818e-01,1.1942306934504916e-03,3.0775904604706883e-03,7.5494733831529565e-03,
1.2025081921547727e+00,1.0583923913420801e+00,2.1911093064942905e-02,2.2643138688981240e-02,2.8197063624854170e-02,1.2047650937987366e+00,1.9636021049797225e-02,2.0714017046814262e-02,1.9222366697123076e-02,3.2537484515588390e-02,4.6834589751673761e-01,4.7105223815381814e-01,4.2899039847870857e-01,3.9761099261243719e-03,9.7165746988137781e-03,
1.2309187977076799e+00,1.0577291767853041e+00,1.9074605674116077e-02,2.5697739698443217e-02,2.8077498551200068e-02,1.2323810465672569e+00,4.1862667151863237e-02,1.7895082041852924e-02,1.9433525456148418e-02,4.5094412710091386e-01,6.9937950936462712e-02,4.8812308137967425e-01,1.7976287256852316e-03,4.8150026796894574e-01,1.1402367965628404e-02,
1.2617240883012379e+00,1.0577976248138516e+00,2.1853757394516754e-02,2.7160396943316664e-02,2.7958936310948024e-02,1.2620258242244682e+00,1.2408540381507663e-01,7.9842968700707978e-02,2.4155604414752584e-02,3.6029259680785887e-02,7.1271065908831588e-02,5.1298748570157326e-01,5.1100850370506690e-01,5.1765732922747221e-01,1.4595049284808788e-02,
1.2619725202708560e+00,1.0568059412800235e+00,1.7539699055639249e-02,2.3685638853954111e-02,3.4396484166387284e-02,1.2623479363143217e+00,6.9803056732453198e-02,4.6806967277025484e-02,5.3112172210615330e-02,4.5103061714875503e-01,4.8651233193033361e-01,1.1472429274486162e-01,2.2006044818730706e-03,5.7499021607679288e-03,4.8918076917035946e-01,
1.2769122288557144e+00,1.0570173369816784e+00,2.2854054207253685e-02,2.6514920501291298e-02,3.5302093641105058e-02,1.2766140230221228e+00,3.1412367653814688e-01,3.2422252902552247e-02,4.1704084915352768e-01,3.5287175680677976e-02,4.8775023308209775e-01,1.1337370964818558e-01,5.5394214710074707e-01,7.3976606363057324e-03,5.2984742196177725e-01,
1.2823213979711015e+00,1.0558011424617191e+00,2.2338059799848216e-02,2.6981287093239659e-02,3.4273146647175061e-02,1.2819625630435205e+00,7.6513611402673778e-02,1.6783564726808858e-01,3.8541771480450382e-01,4.9340491565342548e-01,7.2903266534203606e-02,1.1685799576525571e-01,3.3255608858180118e-03,5.4251577996745692e-01,5.6654950381717462e-01,
1.2879763902391062e+00,1.0553738198889895e+00,2.1694196838444264e-02,2.6189840152467808e-02,3.5171631633263756e-02,1.2871807047685873e+00,9.9615415226251458e-01,1.6064506475778737e+00,2.0727114760851384e+00,3.8133360197609698e-02,7.5409578412445416e-02,1.1723455171379245e-01,5.8989087043573640e-01,5.7274017523611032e-01,6.1037278629151137e-01,

