1
1
15
0
(8 0
((0,0,0) (7,7,7) (0,0,0))
((8,0,0) (15,7,7) (0,0,0))
((0,8,0) (7,15,7) (0,0,0))
((8,8,0) (15,15,7) (0,0,0))
((0,0,8) (7,7,15) (0,0,0))
((8,0,8) (15,7,15) (0,0,0))
((0,8,8) (7,15,15) (0,0,0))
((8,8,8) (15,15,15) (0,0,0))
)
8
FabOnDisk: Cell_D_00000 0
FabOnDisk: Cell_D_00000 61527
FabOnDisk: Cell_D_00000 123055
FabOnDisk: Cell_D_00000 184583
FabOnDisk: Cell_D_00000 246112
FabOnDisk: Cell_D_00000 307640
FabOnDisk: Cell_D_00000 369169
FabOnDisk: Cell_D_00000 430698

8,15
1.17619062047189579e-02,4.83759064023549581e-03,-1.41364086160369051e-02,-7.91903497899851087e-03,-6.89570702844831060e-03,6.26452732591895933e-01,-1.95650566255115878e-03,-3.94276697382565759e-03,-1.80207127714836039e-02,-1.05622386091365015e-02,-2.62509765285052384e-02,-5.88362562435053166e-02,-4.59620307059261268e-01,-4.64635103095464075e-01,-5.00792448858663142e-01,
1.15718816754279627e-02,2.14060411823222040e-03,-8.20941775383745437e-03,-9.64195713796332961e-03,-5.22263084853220004e-03,6.31688314188848965e-01,-8.60348267189895398e-03,-1.23306899623749493e-04,-1.08795476802802694e-02,-4.24427035986834567e-01,-3.23723011664662566e-02,-7.14677831382547063e-02,-5.06307892320763675e-02,-5.15190925691876078e-01,-5.20180943286057018e-01,
1.16576850879401301e-02,1.35710260794316717e-03,-1.28769548572452985e-02,-3.23259232301407150e-03,-4.52865664722860474e-03,6.29041675853031723e-01,-1.92018749646550245e-03,-7.45721064528185283e-03,-1.18228527822416395e-02,-1.48634840929500744e-02,-4.45074323460754706e-01,-7.79535999181530520e-02,-5.17262217677359359e-01,-1.04181926168316868e-01,-5.53177920846498972e-01,
1.15997648243639385e-02,2.20460899951748011e-04,-1.13934903716548554e-02,-5.41958672204506144e-03,-6.20054814059219517e-03,6.28063850622495146e-01,-4.68688771754368211e-02,-5.69901163188134691e-02,-1.37894806856782792e-01,-4.64525206180776140e-01,-4.52781667339043126e-01,-9.69440614251165234e-02,-5.39193694228404588e-02,-1.07885937146710242e-01,-6.04952362988077974e-01,
1.17133270892845719e-02,3.25389460481742619e-04,-1.33753623371639721e-02,-8.88122877300664797e-03,-1.14919457278335815e-03,6.28029991451403591e-01,-3.15151049349291779e-02,-1.57105367542965391e-01,-1.59010765996254633e-01,-1.76920684730988050e-02,-4.40930060133090662e-02,-4.44644875524396355e-01,-5.36931572736655260e-01,-5.75147983050518952e-01,-1.74489702187134166e-01,
1.16793757429231419e-02,-5.12587219935611935e-04,-1.12205541402749485e-02,-1.42919662164534556e-02,-3.04485434711399775e-03,6.28507294808304362e-01,-3.40384238033419328e-02,-6.71041098856787421e-01,-6.48457297939961208e-01,-4.78517562614174774e-01,-5.40272472951961805e-02,-4.76948820865124301e-01,-5.38028705076504590e-02,-5.91286669511662311e-01,-1.72811637244743049e-01,
1.17995146248525799e-02,-1.13131076112697325e-03,-1.45877565029013216e-02,-1.00327658598797186e-02,-9.62466146361096522e-03,6.24938875596584453e-01,-1.33723909759041204e+00,-6.67985863082991682e-01,-2.52247660797509665e+00,-2.47406950637872117e-02,-4.54415451349044430e-01,-4.95982559952511615e-01,-5.74286983084924874e-01,-1.10712158653242326e-01,-1.77079716772772733e-01,
1.17466560550414413e-02,-6.12616605701587786e-03,-3.27194313917133217e-02,-2.78695226733816602e-02,-3.97400806911940435e-02,6.24832138013117433e-01,-7.80608019283864363e-01,-1.78847783039814168e+00,-3.03975589582220440e+00,-4.82703047671710350e-01,-4.90233137386792306e-01,-5.15041273123283183e-01,-5.92582228934233970e-02,-1.14045015794358273e-01,-1.79672416301613708e-01,

8,15
1.14071033006703848e+00,1.05755437723399615e+00,1.75879622345909703e-02,2.21123356399399763e-02,2.81639596855317517e-02,1.14554792070727407e+00,1.53173815113609238e-02,1.52532243893170015e-02,1.90267965557620981e-02,4.37698833643617835e-01,4.46025467325987357e-01,4.38428448460175479e-01,1.20930630032066271e-03,3.04033791795728717e-03,7.24797249608466216e-03,
1.20504691138260833e+00,1.05831752972546944e+00,2.19085994519923333e-02,2.28501872261295536e-02,2.81415455662763804e-02,1.20718751550084047e+00,1.25621106124873087e-02,2.05477299692390647e-02,1.94630267797743506e-02,3.21888364930076262e-02,4.69083998587372597e-01,4.73087614569577541e-01,4.29437278246050713e-01,3.93854505539895094e-03,9.22302094517887111e-03,
1.23136120180218644e+00,1.05772492588623823e+00,1.92988499037510947e-02,2.59485229266971304e-02,2.80353877394044076e-02,1.23271830441012953e+00,6.08763821939651492e-02,2.35564537023000252e-02,1.93413308433382364e-02,4.51345359284381686e-01,6.84079753789473555e-02,4.89210136690100050e-01,1.82026661186711694e-03,4.82762170254679934e-01,1.05918932462078091e-02,
1.26114487046547774e+00,1.05811684946477880e+00,2.19767767400361677e-02,2.70271813950850454e-02,2.79142915979967675e-02,1.26136533136542939e+00,1.62860939065184729e-01,1.07731053890495795e-01,8.53907265041815439e-02,3.67173407593334861e-02,7.03616633202169967e-02,5.13293324431957743e-01,5.12413446954956164e-01,5.19032960935671417e-01,1.34454493631441189e-02,
1.26319066360490639e+00,1.05681743384211035e+00,1.79946196622576410e-02,2.51744120718982722e-02,3.43665895840939081e-02,1.26351605306538817e+00,1.05446300837372636e-01,1.30627800976074793e-01,1.42436177126729013e-01,4.51053307470026810e-01,4.85325211823487201e-01,1.12873788829635363e-01,2.21818995102472574e-03,5.61161006060861920e-03,4.95967904738047860e-01,
1.27798766146374954e+00,1.05694826394056252e+00,2.25736884988578940e-02,3.39796410132664622e-02,3.51032754949265682e-02,1.27795215082811708e+00,1.21307354140717605e+00,1.56576749495615564e-01,1.33034615592213912e-01,3.58125679734997010e-02,4.86381505541237991e-01,1.12657280035377005e-01,5.55181413562814363e-01,7.24201772949145499e-03,5.34098853533236939e-01,
1.28138769609865033e+00,1.05584226686524896e+00,3.54478553604611127e-02,2.67264905981833348e-02,3.40076701643502455e-02,1.28050979140752230e+00,7.74979562208827771e-02,1.63043135226423219e-01,2.05027431961537165e-01,4.93585890143816430e-01,7.23501930990008563e-02,1.14791488607357620e-01,3.34832928417848038e-03,5.44758029037684666e-01,5.77091304840096075e-01,
1.29369916771407323e+00,1.05548113072235017e+00,2.14690133951777884e-02,2.59484212699841038e-02,3.49752643553487286e-02,1.29394900535201174e+00,1.89119122568661391e+00,3.06865535571738945e+00,2.93680227705178343e+00,3.89374694375649311e-02,7.41517424713849238e-02,1.15367746729652637e-01,5.89108222056809794e-01,5.70927791619622704e-01,6.29101006778795990e-01,

