1
1
15
0
(8 0
((0,0,0) (7,7,7) (0,0,0))
((8,0,0) (15,7,7) (0,0,0))
((0,8,0) (7,15,7) (0,0,0))
((8,8,0) (15,15,7) (0,0,0))
((0,0,8) (7,7,15) (0,0,0))
((8,0,8) (15,7,15) (0,0,0))
((0,8,8) (7,15,15) (0,0,0))
((8,8,8) (15,15,15) (0,0,0))
)
8
FabOnDisk: Cell_D_00000 0
FabOnDisk: Cell_D_00000 61527
FabOnDisk: Cell_D_00000 123055
FabOnDisk: Cell_D_00000 184583
FabOnDisk: Cell_D_00000 246112
FabOnDisk: Cell_D_00000 307640
FabOnDisk: Cell_D_00000 369169
FabOnDisk: Cell_D_00000 430698

8,15
1.17522105261150950e-02,5.11721330916872514e-03,-1.44400403052545815e-02,-7.86428460245971149e-03,-6.73579391217703043e-03,6.26551880143592532e-01,-1.89440811784104528e-03,-1.00943660254322661e-02,-2.05055570667966661e-02,-1.04402734630964500e-02,-2.65922482767208326e-02,-6.24243219181548487e-02,-4.56680043525483303e-01,-4.61393667274073993e-01,-5.01900211700070376e-01,
1.15634868472394362e-02,2.25690164396399363e-03,-8.11621396092257127e-03,-9.58354681216963891e-03,-5.03384992904982315e-03,6.31747964909495474e-01,-1.93326407037239627e-02,-1.20416746057283898e-02,-2.21428171860152539e-02,-4.22820342439403474e-01,-3.27232388941559593e-02,-7.59919256941400667e-02,-5.11552976216997149e-02,-5.13146626351024926e-01,-5.16597602754539253e-01,
1.16531877341706502e-02,1.46224885957694280e-03,-1.29729570335033167e-02,-2.96136633395911383e-03,-4.16185042385290409e-03,6.29332394818050256e-01,-1.82906239822769670e-03,-6.77694938122577663e-03,-1.67418312558246206e-02,-1.46843864520025767e-02,-4.44125001398982033e-01,-8.68777602879012845e-02,-5.16525133411950721e-01,-1.05959278024674489e-01,-5.51094304454753603e-01,
1.16148578077400633e-02,3.01735923230312157e-04,-1.13632065661606850e-02,-5.37630411108434673e-03,-7.17599510968568340e-03,6.27943520038225511e-01,-6.97563106809898498e-02,-4.91343193935559336e-02,-2.06005491385179262e-01,-4.63813576436916231e-01,-4.51728544444763958e-01,-1.05168511441679990e-01,-5.32783513782261881e-02,-1.09059577242608952e-01,-6.03924616211633070e-01,
1.16999904731123934e-02,3.75416043465717189e-04,-1.36359595452243462e-02,-7.02119083893803543e-03,-1.04984890850116398e-03,6.28574401727735044e-01,-1.34805224843400108e-02,-3.65708989647174354e-02,-9.46122894876232773e-04,-1.75579719437822246e-02,-4.51647155829534297e-02,-4.44827834240286824e-01,-5.36562199372333515e-01,-5.75781277987891249e-01,-1.76395599828505972e-01,
1.16742838567084860e-02,-2.98205833591655292e-04,-9.96676507384044313e-03,-1.38973957152669809e-02,-1.36134784634792593e-03,6.29814113470168913e-01,-9.68739003639792484e-02,-2.41262901334893642e-01,-6.65230498095034564e-04,-4.78313417672710628e-01,-5.52006301849803510e-02,-4.75974482222737527e-01,-5.34652208181356642e-02,-5.93310872338664974e-01,-1.73709201081420572e-01,
1.17876663050111539e-02,-3.58834927580831793e-04,-1.17869356327386619e-02,-6.93217972407930011e-03,-8.64072775458446171e-04,6.26928388978525541e-01,-2.48179353491030028e-02,-1.08511720166576155e-02,-1.77405019789565049e-02,-2.45583281617571432e-02,-4.56393247727048312e-01,-4.93485884224702132e-01,-5.75311699871507987e-01,-1.12268204230950866e-01,-1.80775418687750739e-01,
1.17567199891041897e-02,-7.95685470518988540e-04,-1.45352703290005693e-02,-1.25949216933049449e-02,-3.36065402511096824e-03,6.25059529695987437e-01,-2.33064195232960784e-02,-4.95665829979292580e-02,-2.19568838922084286e-02,-4.82893768246797750e-01,-4.92087996207186518e-01,-5.11449258910385507e-01,-5.79434776105869631e-02,-1.14556068874165543e-01,-1.82420661729798900e-01,

8,15
1.13618391972560939e+00,1.05761696982718489e+00,1.75573061443460195e-02,2.23076096882270682e-02,2.82155910708334345e-02,1.14130113303477820e+00,1.36752743050279971e-02,1.49934169273950556e-02,1.91344593172405909e-02,4.36649988230643271e-01,4.44639510453094466e-01,4.35667047651268180e-01,1.19423069345049159e-03,3.07759046047068833e-03,7.54947338315295653e-03,
1.20250819215477267e+00,1.05839239134208007e+00,2.19110930649429048e-02,2.26431386889812403e-02,2.81970636248541698e-02,1.20476509379873664e+00,1.96360210497972254e-02,2.07140170468142620e-02,1.92223666971230757e-02,3.25374845155883899e-02,4.68345897516737608e-01,4.71052238153818137e-01,4.28990398478708568e-01,3.97610992612437188e-03,9.71657469881377807e-03,
1.23091879770767987e+00,1.05772917678530409e+00,1.90746056741160769e-02,2.56977396984432171e-02,2.80774985512000676e-02,1.23238104656725689e+00,4.18626671518632365e-02,1.78950820418529236e-02,1.94335254561484178e-02,4.50944127100913861e-01,6.99379509364627117e-02,4.88123081379674251e-01,1.79762872568523164e-03,4.81500267968945739e-01,1.14023679656284037e-02,
1.26172408830123794e+00,1.05779762481385164e+00,2.18537573945167540e-02,2.71603969433166642e-02,2.79589363109480245e-02,1.26202582422446818e+00,1.24085403815076628e-01,7.98429687007079780e-02,2.41556044147525836e-02,3.60292596807858870e-02,7.12710659088315879e-02,5.12987485701573265e-01,5.11008503705066897e-01,5.17657329227472207e-01,1.45950492848087882e-02,
1.26197252027085605e+00,1.05680594128002348e+00,1.75396990556392490e-02,2.36856388539541107e-02,3.43964841663872839e-02,1.26234793631432174e+00,6.98030567324531975e-02,4.68069672770254838e-02,5.31121722106153299e-02,4.51030617148755031e-01,4.86512331930333608e-01,1.14724292744861622e-01,2.20060448187307063e-03,5.74990216076792880e-03,4.89180769170359464e-01,
1.27691222885571443e+00,1.05701733698167843e+00,2.28540542072536851e-02,2.65149205012912975e-02,3.53020936411050576e-02,1.27661402302212279e+00,3.14123676538146879e-01,3.24222529025522468e-02,4.17040849153527682e-01,3.52871756806779763e-02,4.87750233082097751e-01,1.13373709648185578e-01,5.53942147100747073e-01,7.39766063630573241e-03,5.29847421961777254e-01,
1.28232139797110145e+00,1.05580114246171908e+00,2.23380597998482158e-02,2.69812870932396587e-02,3.42731466471750609e-02,1.28196256304352052e+00,7.65136114026737785e-02,1.67835647268088584e-01,3.85417714804503819e-01,4.93404915653425480e-01,7.29032665342036063e-02,1.16857995765255712e-01,3.32556088581801180e-03,5.42515779967456924e-01,5.66549503817174616e-01,
1.28797639023910615e+00,1.05537381988898948e+00,2.16941968384442643e-02,2.61898401524678082e-02,3.51716316332637557e-02,1.28718070476858726e+00,9.96154152262514581e-01,1.60645064757787370e+00,2.07271147608513839e+00,3.81333601976096975e-02,7.54095784124454160e-02,1.17234551713792448e-01,5.89890870435736403e-01,5.72740175236110316e-01,6.10372786291511371e-01,

