1
1
15
0
(8 0
((0,0,0) (7,7,7) (0,0,0))
((8,0,0) (15,7,7) (0,0,0))
((0,8,0) (7,15,7) (0,0,0))
((8,8,0) (15,15,7) (0,0,0))
((0,0,8) (7,7,15) (0,0,0))
((8,0,8) (15,7,15) (0,0,0))
((0,8,8) (7,15,15) (0,0,0))
((8,8,8) (15,15,15) (0,0,0))
)
8
FabOnDisk: Cell_D_00000 0
FabOnDisk: Cell_D_00000 61527
FabOnDisk: Cell_D_00000 123055
FabOnDisk: Cell_D_00000 184583
FabOnDisk: Cell_D_00000 246112
FabOnDisk: Cell_D_00000 307640
FabOnDisk: Cell_D_00000 369169
FabOnDisk: Cell_D_00000 430698

8,15
1.22046812128180915e-02,1.37715002170805019e-02,-1.44987226083619792e-02,-1.18588875211086756e-02,-6.86923215915453099e-03,6.28965774317719606e-01,-2.15374099439458568e-03,5.60269866713418224e-04,-1.03912703108810294e-03,-1.01112391977437772e-02,-3.03884076654099902e-02,-8.61092019690012644e-02,-3.96855332988512943e-01,-4.44900440421569621e-01,-5.03030681518672251e-01,
1.20077586988502766e-02,5.46152504541927344e-03,-9.09591333973565688e-03,-1.19876158333353331e-02,-5.55091779858565317e-03,6.28324147344534456e-01,-8.79207934561429018e-03,-7.96119037735750802e-03,-2.31105499687507196e-02,-3.94632135318068289e-01,-3.83411439923458525e-02,-1.06790574971729238e-01,-6.60190759700239466e-02,-4.65120422084094820e-01,-5.36732267883605618e-01,
1.20461527409792789e-02,2.62364074134830089e-03,-1.37831643400675823e-02,-6.18821331333076728e-03,-6.05303154050951080e-03,6.28767425575373351e-01,-1.54873184022944962e-03,-3.90477495081862410e-03,-5.73206638727086631e-02,-1.56451464423234543e-02,-4.28152655502607227e-01,-1.28908813891822127e-01,-4.95082019605017187e-01,-1.37118768065222107e-01,-5.48371885501801604e-01,
1.20536943162521098e-02,9.38626174902650111e-04,-1.24220186136925481e-02,-7.36687662852162761e-03,-7.70429236936889198e-03,6.28537455211967799e-01,-3.68782483003774683e-02,-8.14524074959313733e-03,-3.01113761105841655e-02,-4.52302733571047888e-01,-4.36211898351291039e-01,-1.57935956119912596e-01,-6.78655933142261608e-02,-1.39207501591073729e-01,-5.68311151532196246e-01,
1.21000010641629189e-02,8.68478092575555838e-04,-1.19022704556206622e-02,-9.93570402507945594e-03,-4.23707865786166447e-03,6.29045653097701107e-01,-1.02767860415742367e-02,-2.10462362059570043e-02,-4.50091934456269861e-03,-1.96940084510627070e-02,-5.92934304416852798e-02,-4.52240215495908759e-01,-5.38197029969543883e-01,-5.67403418247794278e-01,-2.20247523260018507e-01,
1.21243133674942410e-02,-1.42927580186484788e-04,-1.34803644625530201e-02,-1.15255849099403992e-02,-5.33765183024801932e-03,6.27389026629401769e-01,-1.83348425537089924e-02,-5.45057656241340838e-01,-6.61751056571527069e-03,-4.72138858978297993e-01,-7.39921663690436548e-02,-4.77313253110917102e-01,-6.62608275378647193e-02,-6.07769522508414872e-01,-2.22390005340118130e-01,
1.21839483488602636e-02,-6.12047269885676853e-04,-1.22571295266213562e-02,-1.02537943866421490e-02,-5.39328220736920612e-03,6.29047823405662232e-01,-3.59735729095752854e-02,-1.76259685320281301e-01,-2.62522718022564147e-02,-2.99688027276630922e-02,-4.71316043703361776e-01,-4.90274263644164876e-01,-5.56856752008748845e-01,-1.41816668272773061e-01,-2.25618701558871759e-01,
1.22361442354571182e-02,-7.25192759886952886e-04,-1.72845820732023259e-02,-1.44839531209224534e-02,-7.22493899299169774e-03,6.28732114319248026e-01,-4.50061569393821331e-02,-1.67812007535453334e-02,-2.38608392218739689e-02,-4.76867625454797495e-01,-5.03939100195857415e-01,-4.93249508748138221e-01,-7.17949271327711358e-02,-1.43179342849356545e-01,-2.26329611221235349e-01,

8,15
1.02337645381046571e+00,1.05578232161994623e+00,1.61667978363696473e-02,1.98288339646017255e-02,2.47253026228490061e-02,1.06800969641068821e+00,1.25694710214809095e-02,1.17959776995118608e-02,1.43513104777891511e-02,4.09771843682635417e-01,4.02747172847352952e-01,4.54309859750173628e-01,1.13253726862488349e-03,3.46973612321678070e-03,1.09983500589229746e-02,
1.12734523570924283e+00,1.05662774365031509e+00,2.09729922901107819e-02,2.15460417813670702e-02,2.49975709103563426e-02,1.13280676075466213e+00,9.63148301335282550e-03,1.32397747621464841e-02,1.80754586476744965e-02,4.24133262023201063e-02,4.37446728623770487e-01,4.58013893515011095e-01,4.04313813805772304e-01,4.60597089453310474e-03,1.46800151244591108e-02,
1.19271691375547628e+00,1.05634334827254595e+00,1.88051300031926577e-02,2.50213431483613871e-02,2.43356428065175032e-02,1.19534055449682453e+00,1.67341381584936687e-02,3.67848558677440485e-02,1.55239220743016992e-02,4.52565631070135477e-01,8.83071198286628639e-02,4.56212168122898332e-01,1.88627792393256935e-03,4.51244695068363788e-01,1.88097560732565713e-02,
1.24458896707553568e+00,1.05601915383217326e+00,2.04460444397679200e-02,2.57570896278456127e-02,2.63932099607542235e-02,1.24552759325043838e+00,2.69163231334806005e-02,2.06613327751072676e-02,1.98642121492973167e-02,4.44895981913697169e-02,8.87689900001492616e-02,4.91080166518134797e-01,4.85146382736894533e-01,4.91532273515721374e-01,2.49482507378353258e-02,
1.24967389268394502e+00,1.05590046816889616e+00,1.99424733501612321e-02,2.21327665485238495e-02,2.89097164128221742e-02,1.25054237077652064e+00,5.07700737810714842e-02,2.75986607362034772e-02,3.14715516843240492e-02,4.60892709986641891e-01,4.91673770006474942e-01,1.41868838034635458e-01,2.42851674003109752e-03,7.57316165944624253e-03,4.80907736180372636e-01,
1.27468028411048206e+00,1.05558854658400936e+00,1.96709841132176946e-02,2.46765247297977969e-02,2.88030239656697287e-02,1.27453735653029554e+00,1.70315572522251935e-01,2.39293224665212273e-02,3.03793554443680169e-01,4.41372891181073604e-02,5.04178735342002526e-01,1.42891131924985204e-01,5.40550508756968751e-01,1.00135009030026291e-02,5.37197100268328676e-01,
1.28476672568212558e+00,1.05488373078989239e+00,2.24293818108469711e-02,2.50198610503201205e-02,2.74577280618506885e-02,1.28435767361983078e+00,6.80685751484994828e-02,6.72769776675324199e-02,6.81967765451881175e-02,4.80984739750786094e-01,9.08817249744203332e-02,1.44335389341685605e-01,4.05657362521790171e-03,5.28058786697636173e-01,5.76839199473329955e-01,
1.29098624126090433e+00,1.05403002173663607e+00,1.92221982772623895e-02,2.43102328449608870e-02,2.79603115445680832e-02,1.29026104850101730e+00,2.00007953420263007e+00,7.50194465417750811e-01,1.64422648992546017e+00,4.65023852207847935e-02,9.22123096272219334e-02,1.44765466393937448e-01,5.81832846612178711e-01,5.92685424055815369e-01,6.01986691934011664e-01,

