1
1
15
0
(8 0
((0,0,0) (7,7,7) (0,0,0))
((8,0,0) (15,7,7) (0,0,0))
((0,8,0) (7,15,7) (0,0,0))
((8,8,0) (15,15,7) (0,0,0))
((0,0,8) (7,7,15) (0,0,0))
((8,0,8) (15,7,15) (0,0,0))
((0,8,8) (7,15,15) (0,0,0))
((8,8,8) (15,15,15) (0,0,0))
)
8
FabOnDisk: Cell_D_00000 0
FabOnDisk: Cell_D_00000 61527
FabOnDisk: Cell_D_00000 123055
FabOnDisk: Cell_D_00000 184583
FabOnDisk: Cell_D_00000 246112
FabOnDisk: Cell_D_00000 307640
FabOnDisk: Cell_D_00000 369169
FabOnDisk: Cell_D_00000 430698

8,15
1.22080535370567289e-02,1.28278705690598877e-02,-1.45406704968266652e-02,-1.16344296681095312e-02,-7.20380302720108334e-03,6.29866547398548415e-01,-2.09627540627710775e-03,5.57713352211609533e-04,-2.68666393578311175e-03,-1.03448658277806756e-02,-2.99965661029939490e-02,-8.35480140568508056e-02,-4.01549450939636954e-01,-4.45125120033990351e-01,-5.04222822749911925e-01,
1.20097975998365251e-02,5.06589859178581837e-03,-9.06990375138664630e-03,-1.18398813557608201e-02,-5.91546694720081721e-03,6.28388885977386291e-01,-8.17958948973300862e-03,-9.23801766872610862e-03,-2.52601179463932367e-02,-3.97812273790915161e-01,-3.78825459355595640e-02,-1.03744650767425450e-01,-6.62840580216812469e-02,-4.63456967534340181e-01,-5.35946612197967465e-01,
1.20480768259603205e-02,2.50695672966674528e-03,-1.36710783023943905e-02,-6.46193675438921315e-03,-6.30789276752641292e-03,6.28763862417132779e-01,-1.63429182299314950e-03,-3.44908675310714053e-03,-3.49857317670827644e-02,-1.59135060683427421e-02,-4.29349086604878583e-01,-1.24149358241887192e-01,-4.97471733462948429e-01,-1.35117650607293693e-01,-5.45319138623726274e-01,
1.20542932977243025e-02,9.12830100787631062e-04,-1.25400783919347013e-02,-7.51362657318584929e-03,-7.45889041525313237e-03,6.28504690908530561e-01,-3.97492825496857383e-02,-8.89417681039635956e-03,-2.95562218620870551e-02,-4.53571155696495032e-01,-4.37462744286641336e-01,-1.52389567436283679e-01,-6.81830597378803166e-02,-1.36977625790465601e-01,-5.72137598202129727e-01,
1.21018367727409957e-02,8.19355987911597815e-04,-1.18189907501477110e-02,-9.60081629094284780e-03,-4.32267663345904662e-03,6.29321441270553006e-01,-1.12106117989006389e-02,-2.28367460965723523e-02,-4.61752645638776119e-03,-1.99706915480008518e-02,-5.78314505338166224e-02,-4.51849095223611219e-01,-5.39453331194955976e-01,-5.68542379179768798e-01,-2.16583076133160690e-01,
1.21260875068292650e-02,-1.70139600560603911e-04,-1.35070144198280798e-02,-1.19122675405186756e-02,-5.42421156410472470e-03,6.27383924566429108e-01,-1.63743656438550718e-02,-1.13932092821015951e+00,-6.12147137559275554e-03,-4.72463368577414333e-01,-7.22483572273178859e-02,-4.77897964301480238e-01,-6.63891267832110304e-02,-6.07412725123614550e-01,-2.18981120136669066e-01,
1.21832305198470575e-02,-4.13149858221259383e-04,-1.22848242645341912e-02,-1.02655510495759539e-02,-5.53464957806743853e-03,6.29182522580989390e-01,-2.71672480200358113e-02,-1.05319011350570174e-01,-2.54717346574036482e-02,-3.02038423107370453e-02,-4.69846984556827718e-01,-4.91449377281946820e-01,-5.56880472908457658e-01,-1.38929474164310174e-01,-2.22058161351750882e-01,
1.22353515824096780e-02,-7.95460939764024307e-04,-1.73813374964346193e-02,-1.46706094826846659e-02,-7.28986431858636395e-03,6.28547836698687634e-01,-4.28436754136762299e-02,-1.66728001523834719e-02,-2.32332955087823437e-02,-4.76783961490488128e-01,-5.03252548273340206e-01,-4.95504502029828986e-01,-7.24779291340786613e-02,-1.40763081287463454e-01,-2.22661587643446124e-01,

8,15
1.03269530480200999e+00,1.05577749382223818e+00,1.61986860612590780e-02,1.96269187572573091e-02,2.45485618281105836e-02,1.06800912954530913e+00,1.20884807622536790e-02,1.20859980538675360e-02,1.41954057569970045e-02,4.12260357218421025e-01,4.02470543036145600e-01,4.53350658923486027e-01,1.15967787946242868e-03,3.42684991130301139e-03,1.05866348548533488e-02,
1.13476152811762931e+00,1.05662501168034573e+00,2.10371563811911216e-02,2.18131120715398877e-02,2.48561321881372206e-02,1.13982742670941506e+00,1.04084673771417165e-02,1.39929885482411483e-02,1.82208309862651290e-02,4.24788621918229525e-02,4.40665838924867270e-01,4.55571138921189223e-01,4.06134917829349018e-01,4.55425438986052904e-03,1.41321952287853381e-02,
1.19597915910327468e+00,1.05634304689755609e+00,1.89170440499817939e-02,2.49463143277507335e-02,2.41844142807609158e-02,1.19848611583294140e+00,1.73796279542796708e-02,9.43551380538100622e-03,1.53742118793387551e-02,4.53342657682141215e-01,8.68195161540901705e-02,4.53641904256948503e-01,1.92028706014109188e-03,4.53384522699502190e-01,1.78703242144196139e-02,
1.24661318317179459e+00,1.05601175198037289e+00,2.03655158690291202e-02,2.57006376754009280e-02,2.61989086866383641e-02,1.24752601327258228e+00,5.47922010002935556e-02,2.28042857775064417e-02,1.98730678914555009e-02,4.48331045645339876e-02,8.76373783331392958e-02,4.93617791698890973e-01,4.88249549274269390e-01,4.93766955274780095e-01,2.37085819203597392e-02,
1.25111764786258584e+00,1.05589766229086646e+00,1.99685424760503542e-02,2.23381436763729069e-02,2.89476681045568382e-02,1.25193700385049733e+00,5.16910802869051320e-02,2.98161215003778582e-02,3.18125151826977107e-02,4.61043394303229770e-01,4.91669575040465379e-01,1.39692841229840103e-01,2.46593494024197144e-03,7.37981300327114099e-03,4.80107835051527654e-01,
1.27561487032554433e+00,1.05557744022421907e+00,1.96247192476498161e-02,2.49381723861879234e-02,2.88434861776450877e-02,1.27544473072498366e+00,4.48717306036820029e-01,2.47404390105889008e-02,7.34961627142893592e-01,4.43335512133798543e-02,5.02949973021761698e-01,1.40759807119456681e-01,5.42207302491363841e-01,9.76802288954502912e-03,5.37374565543598970e-01,
1.28484092328459987e+00,1.05489909920779379e+00,2.26136110674213381e-02,2.50065934776830673e-02,2.76011357681946491e-02,1.28442777342637870e+00,6.82471962803519044e-02,6.07249663561322886e-02,5.41563903371537064e-02,4.80930200328557933e-01,8.89859838375121615e-02,1.41912834954778799e-01,4.09012363358551151e-03,5.25827726053765154e-01,5.76609259195798973e-01,
1.29113904032917048e+00,1.05405018850806198e+00,1.92352529362965624e-02,2.42284904916532685e-02,2.80655168749139941e-02,1.29034357938940647e+00,4.22239812215913668e-01,2.34221250120262292e-01,6.77364639522754386e-01,4.68223589920545372e-02,9.06541146499712236e-02,1.42538583563837029e-01,5.81430485250274742e-01,5.91420319108803771e-01,6.04399381403308622e-01,

