1
1
15
0
(8 0
((0,0,0) (7,7,7) (0,0,0))
((8,0,0) (15,7,7) (0,0,0))
((0,8,0) (7,15,7) (0,0,0))
((8,8,0) (15,15,7) (0,0,0))
((0,0,8) (7,7,15) (0,0,0))
((8,0,8) (15,7,15) (0,0,0))
((0,8,8) (7,15,15) (0,0,0))
((8,8,8) (15,15,15) (0,0,0))
)
8
FabOnDisk: Cell_D_00000 0
FabOnDisk: Cell_D_00000 61527
FabOnDisk: Cell_D_00000 123055
FabOnDisk: Cell_D_00000 184583
FabOnDisk: Cell_D_00000 246112
FabOnDisk: Cell_D_00000 307640
FabOnDisk: Cell_D_00000 369169
FabOnDisk: Cell_D_00000 430698

8,15
1.2204681212818091e-02,1.3771500217080502e-02,-1.4498722608361979e-02,-1.1858887521108676e-02,-6.8692321591545310e-03,6.2896577431771961e-01,-2.1537409943945857e-03,5.6026986671341822e-04,-1.0391270310881029e-03,-1.0111239197743777e-02,-3.0388407665409990e-02,-8.6109201969001264e-02,-3.9685533298851294e-01,-4.4490044042156962e-01,-5.0303068151867225e-01,
1.2007758698850277e-02,5.4615250454192734e-03,-9.0959133397356569e-03,-1.1987615833335333e-02,-5.5509177985856532e-03,6.2832414734453446e-01,-8.7920793456142902e-03,-7.9611903773575080e-03,-2.3110549968750720e-02,-3.9463213531806829e-01,-3.8341143992345852e-02,-1.0679057497172924e-01,-6.6019075970023947e-02,-4.6512042208409482e-01,-5.3673226788360562e-01,
1.2046152740979279e-02,2.6236407413483009e-03,-1.3783164340067582e-02,-6.1882133133307673e-03,-6.0530315405095108e-03,6.2876742557537335e-01,-1.5487318402294496e-03,-3.9047749508186241e-03,-5.7320663872708663e-02,-1.5645146442323454e-02,-4.2815265550260723e-01,-1.2890881389182213e-01,-4.9508201960501719e-01,-1.3711876806522211e-01,-5.4837188550180160e-01,
1.2053694316252110e-02,9.3862617490265011e-04,-1.2422018613692548e-02,-7.3668766285216276e-03,-7.7042923693688920e-03,6.2853745521196780e-01,-3.6878248300377468e-02,-8.1452407495931373e-03,-3.0111376110584166e-02,-4.5230273357104789e-01,-4.3621189835129104e-01,-1.5793595611991260e-01,-6.7865593314226161e-02,-1.3920750159107373e-01,-5.6831115153219625e-01,
1.2100001064162919e-02,8.6847809257555584e-04,-1.1902270455620662e-02,-9.9357040250794559e-03,-4.2370786578616645e-03,6.2904565309770111e-01,-1.0276786041574237e-02,-2.1046236205957004e-02,-4.5009193445626986e-03,-1.9694008451062707e-02,-5.9293430441685280e-02,-4.5224021549590876e-01,-5.3819702996954388e-01,-5.6740341824779428e-01,-2.2024752326001851e-01,
1.2124313367494241e-02,-1.4292758018648479e-04,-1.3480364462553020e-02,-1.1525584909940399e-02,-5.3376518302480193e-03,6.2738902662940177e-01,-1.8334842553708992e-02,-5.4505765624134084e-01,-6.6175105657152707e-03,-4.7213885897829799e-01,-7.3992166369043655e-02,-4.7731325311091710e-01,-6.6260827537864719e-02,-6.0776952250841487e-01,-2.2239000534011813e-01,
1.2183948348860264e-02,-6.1204726988567685e-04,-1.2257129526621356e-02,-1.0253794386642149e-02,-5.3932822073692061e-03,6.2904782340566223e-01,-3.5973572909575285e-02,-1.7625968532028130e-01,-2.6252271802256415e-02,-2.9968802727663092e-02,-4.7131604370336178e-01,-4.9027426364416488e-01,-5.5685675200874885e-01,-1.4181666827277306e-01,-2.2561870155887176e-01,
1.2236144235457118e-02,-7.2519275988695289e-04,-1.7284582073202326e-02,-1.4483953120922453e-02,-7.2249389929916977e-03,6.2873211431924803e-01,-4.5006156939382133e-02,-1.6781200753545333e-02,-2.3860839221873969e-02,-4.7686762545479749e-01,-5.0393910019585741e-01,-4.9324950874813822e-01,-7.1794927132771136e-02,-1.4317934284935654e-01,-2.2632961122123535e-01,

8,15
1.0233764538104657e+00,1.0557823216199462e+00,1.6166797836369647e-02,1.9828833964601725e-02,2.4725302622849006e-02,1.0680096964106882e+00,1.2569471021480910e-02,1.1795977699511861e-02,1.4351310477789151e-02,4.0977184368263542e-01,4.0274717284735295e-01,4.5430985975017363e-01,1.1325372686248835e-03,3.4697361232167807e-03,1.0998350058922975e-02,
1.1273452357092428e+00,1.0566277436503151e+00,2.0972992290110782e-02,2.1546041781367070e-02,2.4997570910356343e-02,1.1328067607546621e+00,9.6314830133528255e-03,1.3239774762146484e-02,1.8075458647674496e-02,4.2413326202320106e-02,4.3744672862377049e-01,4.5801389351501109e-01,4.0431381380577230e-01,4.6059708945331047e-03,1.4680015124459111e-02,
1.1927169137554763e+00,1.0563433482725459e+00,1.8805130003192658e-02,2.5021343148361387e-02,2.4335642806517503e-02,1.1953405544968245e+00,1.6734138158493669e-02,3.6784855867744048e-02,1.5523922074301699e-02,4.5256563107013548e-01,8.8307119828662864e-02,4.5621216812289833e-01,1.8862779239325693e-03,4.5124469506836379e-01,1.8809756073256571e-02,
1.2445889670755357e+00,1.0560191538321733e+00,2.0446044439767920e-02,2.5757089627845613e-02,2.6393209960754224e-02,1.2455275932504384e+00,2.6916323133480601e-02,2.0661332775107268e-02,1.9864212149297317e-02,4.4489598191369717e-02,8.8768990000149262e-02,4.9108016651813480e-01,4.8514638273689453e-01,4.9153227351572137e-01,2.4948250737835326e-02,
1.2496738926839450e+00,1.0559004681688962e+00,1.9942473350161232e-02,2.2132766548523850e-02,2.8909716412822174e-02,1.2505423707765206e+00,5.0770073781071484e-02,2.7598660736203477e-02,3.1471551684324049e-02,4.6089270998664189e-01,4.9167377000647494e-01,1.4186883803463546e-01,2.4285167400310975e-03,7.5731616594462425e-03,4.8090773618037264e-01,
1.2746802841104821e+00,1.0555885465840094e+00,1.9670984113217695e-02,2.4676524729797797e-02,2.8803023965669729e-02,1.2745373565302955e+00,1.7031557252225193e-01,2.3929322466521227e-02,3.0379355444368017e-01,4.4137289118107360e-02,5.0417873534200253e-01,1.4289113192498520e-01,5.4055050875696875e-01,1.0013500903002629e-02,5.3719710026832868e-01,
1.2847667256821256e+00,1.0548837307898924e+00,2.2429381810846971e-02,2.5019861050320120e-02,2.7457728061850688e-02,1.2843576736198308e+00,6.8068575148499483e-02,6.7276977667532420e-02,6.8196776545188117e-02,4.8098473975078609e-01,9.0881724974420333e-02,1.4433538934168560e-01,4.0565736252179017e-03,5.2805878669763617e-01,5.7683919947332996e-01,
1.2909862412609043e+00,1.0540300217366361e+00,1.9222198277262389e-02,2.4310232844960887e-02,2.7960311544568083e-02,1.2902610485010173e+00,2.0000795342026301e+00,7.5019446541775081e-01,1.6442264899254602e+00,4.6502385220784793e-02,9.2212309627221933e-02,1.4476546639393745e-01,5.8183284661217871e-01,5.9268542405581537e-01,6.0198669193401166e-01,

