1
1
15
0
(8 0
((0,0,0) (7,7,7) (0,0,0))
((8,0,0) (15,7,7) (0,0,0))
((0,8,0) (7,15,7) (0,0,0))
((8,8,0) (15,15,7) (0,0,0))
((0,0,8) (7,7,15) (0,0,0))
((8,0,8) (15,7,15) (0,0,0))
((0,8,8) (7,15,15) (0,0,0))
((8,8,8) (15,15,15) (0,0,0))
)
8
FabOnDisk: Cell_D_00000 0
FabOnDisk: Cell_D_00000 61527
FabOnDisk: Cell_D_00000 123055
FabOnDisk: Cell_D_00000 184583
FabOnDisk: Cell_D_00000 246112
FabOnDisk: Cell_D_00000 307640
FabOnDisk: Cell_D_00000 369169
FabOnDisk: Cell_D_00000 430698

8,15
1.23859588628791421e-02,6.80965512273489504e-02,-1.53649774804788166e-02,-1.42244784727574656e-02,-1.22418629935363288e-02,6.31424613606833995e-01,-2.88616999850600407e-03,-1.76619949407139207e-03,-4.62176731307851097e-04,-9.70159017163574333e-03,-3.74247499191497496e-02,-1.37587038608144419e-01,-3.38829076642961358e-01,-3.77770313188375895e-01,-4.47013350117352604e-01,
1.21479316229422089e-02,2.96741179227141202e-02,-1.01694369191199247e-02,-1.47360178486432552e-02,-1.15905793367428490e-02,6.33511102831532558e-01,-7.37629512492150342e-03,-1.93374593989730317e-03,-9.69700393692814015e-04,-3.56740510618996531e-01,-5.01092316907171056e-02,-1.77027520942027727e-01,-9.32231139619166954e-02,-4.40564663269497725e-01,-4.90485888115065993e-01,
1.21536222980495427e-02,1.02581316068647409e-02,-1.34371842999652623e-02,-1.02535147894864519e-02,-1.08027504470819026e-02,6.29611473505372499e-01,-2.67123930930883522e-03,-9.76000625431216497e-03,-1.91330298098027624e-02,-1.73781260427066098e-02,-3.94705710699516543e-01,-2.23108879797979887e-01,-4.17772640346021462e-01,-1.83956172333233747e-01,-5.60311401679095322e-01,
1.21852022890301236e-02,3.22952587342638549e-03,-1.62475012120606097e-02,-1.49149180458272856e-02,-1.31605781192791534e-02,6.27882300097447610e-01,-1.67945027100211627e-02,-1.27639352195605266e-02,-4.95916426024110568e-02,-4.25549477855446723e-01,-4.04718045218990685e-01,-2.78341112870383545e-01,-9.25054761205915260e-02,-1.83137434257417825e-01,-6.06893593666889331e-01,
1.21830160018999590e-02,2.11588938658364327e-03,-1.34005524786006327e-02,-1.47410769043296412e-02,-1.26163913237955783e-02,6.28632204107537507e-01,-2.96755340825733543e-03,-2.85258111163098765e-02,-5.56571992262990846e-03,-2.51149960123739531e-02,-9.51554104699286057e-02,-4.35091933017499044e-01,-5.12728710402188814e-01,-5.16150568520712283e-01,-2.90229659377741367e-01,
1.22147448000330099e-02,3.63637071897322827e-04,-1.44348749276352363e-02,-1.35817246964443899e-02,-1.17381737020416030e-02,6.29313575168208184e-01,-8.78338659852046233e-02,-1.49937639316243432e-01,-1.85594480006893714e-02,-4.58873529274083647e-01,-1.24737564167099496e-01,-4.44245005032049556e-01,-9.37372654918569581e-02,-5.97032260011345794e-01,-2.96094246312066378e-01,
1.23121249421972358e-02,-4.40913239112322524e-04,-1.49837897429357068e-02,-1.18184631915423926e-02,-1.06217501570748333e-02,6.29964052713751332e-01,-3.64265268220928876e-02,-3.56818898778008542e-02,-1.10880830494775082e-01,-4.38544389376860910e-02,-4.85621124065950760e-01,-4.54689093295755520e-01,-5.82804253158962116e-01,-1.88368143710001240e-01,-2.95034286882274510e-01,
1.24158509498256495e-02,-8.32602349586831049e-04,-1.70359965069241150e-02,-1.20553014827409783e-02,-1.45170671747493398e-02,6.29189771419698118e-01,-5.07376838028391758e-02,-1.27591721445209916e-01,-2.64675050760022268e+00,-4.79313131701248285e-01,-5.05013046213264039e-01,-5.01512764922599774e-01,-9.57732931271985249e-02,-1.91045491723060845e-01,-2.96058413988593339e-01,

8,15
7.45374925490587259e-01,1.05501871352079757e+00,1.29542895829630796e-02,1.56586639232879250e-02,1.62253243791345078e-02,1.06740467238367676e+00,8.89931904718694461e-03,1.12534066261109761e-02,9.24618751762792263e-03,3.66581428928007380e-01,3.98801281646136208e-01,4.14077646927316689e-01,1.07648084043541342e-03,4.29351404918112880e-03,2.17209140211808739e-02,
9.11693479168596888e-01,1.05606836134759208e+00,1.85386500988960895e-02,1.94452622864883032e-02,2.03265120603796402e-02,1.06821858216030496e+00,4.95077107299918707e-03,1.61130680040572072e-02,9.70017027937546648e-03,5.91719905755391032e-02,4.24528012995886272e-01,4.57596548548915738e-01,3.34730315400199097e-01,6.09698768140836019e-03,3.15756531726302733e-02,
1.06007295089921416e+00,1.05605334069843426e+00,1.86344545897088598e-02,1.93691761146771724e-02,1.82417134671360830e-02,1.07033108250607900e+00,1.94954094002116329e-02,1.11565935611954124e-02,1.29405396350270579e-02,4.18226162316212513e-01,1.18899345728590580e-01,4.87912352652483616e-01,2.05118499575877682e-03,3.87176975142427993e-01,4.50183854279742196e-02,
1.17403342317084314e+00,1.05564259814033545e+00,1.63554818669546659e-02,2.00217031771508201e-02,2.11256041953962123e-02,1.17726294904426942e+00,1.95666165376293562e-02,1.30410215351274943e-02,1.31780446640358470e-02,6.05016083904946281e-02,1.18506046446592850e-01,5.00508211147429827e-01,4.28188764874416372e-01,4.37421499948357273e-01,6.47575520930777915e-02,
1.20763839661293959e+00,1.05579392152789131e+00,1.77017361021334155e-02,1.62886241403777839e-02,2.14367267446992429e-02,1.20975428599952317e+00,1.94771549247469145e-02,1.38650240203238573e-02,1.13149984109944864e-02,4.63799251555179204e-01,4.65881773409931199e-01,1.87359199373724084e-01,3.05263905140277939e-03,1.29069789221427471e-02,4.62310664135924587e-01,
1.26055438818911458e+00,1.05536705738649927e+00,1.65305578222431845e-02,1.65409787243235192e-02,2.05241452640320295e-02,1.26091802526101193e+00,1.02326087190937498e-01,1.31063182007663537e-02,4.60355117089864263e-02,6.06892786920674304e-02,5.06475181492901605e-01,1.87408107990796824e-01,5.17185892486913379e-01,1.84532704942982628e-02,5.11333787664723149e-01,
1.28278640118592935e+00,1.05449186295181474e+00,1.89872618568886209e-02,2.02718805418054260e-02,2.09055776226589746e-02,1.28234548794681702e+00,5.79470116362564569e-02,4.56507871908422083e-02,4.30372287829952349e-02,4.78347591484990287e-01,1.20577099376767832e-01,1.86857302967451511e-01,5.93146729337454617e-03,5.53720152114159481e-01,5.30769327813563563e-01,
1.29133101265186379e+00,1.05283973407369857e+00,1.81944117439478900e-02,1.91108516665821730e-02,2.13804908518520007e-02,1.29058939058516753e+00,1.07329400114671270e+00,7.12069533920950182e-01,3.51395527742508040e-01,6.11370705618547242e-02,1.21379915651639692e-01,1.88836063712802982e-01,5.59569779064504003e-01,6.09475154187485768e-01,5.87148105733300119e-01,

