1
1
15
0
(8 0
((0,0,0) (7,7,7) (0,0,0))
((8,0,0) (15,7,7) (0,0,0))
((0,8,0) (7,15,7) (0,0,0))
((8,8,0) (15,15,7) (0,0,0))
((0,0,8) (7,7,15) (0,0,0))
((8,0,8) (15,7,15) (0,0,0))
((0,8,8) (7,15,15) (0,0,0))
((8,8,8) (15,15,15) (0,0,0))
)
8
FabOnDisk: Cell_D_00000 0
FabOnDisk: Cell_D_00000 61527
FabOnDisk: Cell_D_00000 123055
FabOnDisk: Cell_D_00000 184583
FabOnDisk: Cell_D_00000 246112
FabOnDisk: Cell_D_00000 307640
FabOnDisk: Cell_D_00000 369169
FabOnDisk: Cell_D_00000 430698

8,15
1.2384785160500284e-02,7.3537712890328830e-02,-1.5334305330625377e-02,-1.3977142438702413e-02,-1.2243579777809328e-02,6.3087427192922352e-01,-2.8888786114198524e-03,-1.8200947721952053e-03,-3.6990575769436153e-04,-9.4205574983000639e-03,-3.7931550210952181e-02,-1.4135675943089479e-01,-3.3322302601336518e-01,-3.7176738006945459e-01,-4.4851245008626472e-01,
1.2146802911886760e-02,3.2822815136231608e-02,-1.0046985342392241e-02,-1.4530024095928974e-02,-1.1642528231466049e-02,6.3208439897052893e-01,-6.9315989798919373e-03,-1.7919717424107954e-03,-7.1721748619521216e-04,-3.5568902949917636e-01,-5.0758322156323844e-02,-1.8163962005121626e-01,-9.3190419106178563e-02,-4.3573391484221125e-01,-4.8386642087234766e-01,
1.2154079464830625e-02,1.1151484533121888e-02,-1.3277815610112908e-02,-1.0360806861952170e-02,-1.0880615715968576e-02,6.2972582200247262e-01,-2.8258706737981734e-03,-9.7267818732172419e-03,-1.6903530609001821e-02,-1.7021807429661362e-02,-3.9265122729189034e-01,-2.3014220399572671e-01,-4.1613254483229017e-01,-1.8795897374199536e-01,-5.5851170365721503e-01,
1.2185212322646591e-02,3.4978324828744724e-03,-1.6303385526820945e-02,-1.5127427157269198e-02,-1.2986230799370120e-02,6.2788695910293613e-01,-1.7807561123860678e-02,-1.3427707241395078e-02,-5.0613103396194584e-02,-4.2294103783380110e-01,-4.0271883159074484e-01,-2.8638085574624245e-01,-9.2698551047358496e-02,-1.8673324487346221e-01,-6.0837958699533345e-01,
1.2180780691489328e-02,2.1896601654601581e-03,-1.3354055248226736e-02,-1.4576411722009266e-02,-1.2821795497237673e-02,6.2872492854896467e-01,-2.9262728825945896e-03,-3.0084979121496602e-02,-5.1451130862035562e-03,-2.4897949458940988e-02,-9.8291024605421398e-02,-4.3331551517934730e-01,-5.1073872482269078e-01,-5.1760950957454699e-01,-2.9370186355105243e-01,
1.2212295530915832e-02,4.0642916816583725e-04,-1.4386904887251192e-02,-1.3360808576800295e-02,-1.1909310906416563e-02,6.2911000621232738e-01,-8.1037682264239685e-02,-1.2813093047392024e-01,-1.8372060984336046e-02,-4.5849754564482847e-01,-1.2870407970219541e-01,-4.4117210786632965e-01,-9.3807450585866592e-02,-5.9521072347786164e-01,-3.0034284271121303e-01,
1.2314015027135916e-02,-4.4308530037026535e-04,-1.5023627472269329e-02,-1.1817821035312225e-02,-1.0922129041537795e-02,6.2997550122033308e-01,-3.6432162337360748e-02,-2.2807633030940966e-02,-7.3436529303098852e-02,-4.3867194623636308e-02,-4.8615873802014942e-01,-4.5868399223263545e-01,-5.8279572586959150e-01,-1.9148985304224070e-01,-2.9969688996386201e-01,
1.2420614705749563e-02,-8.3736100395614792e-04,-1.7018395924620903e-02,-1.2127244202266286e-02,-1.4443973005988773e-02,6.2901212266496875e-01,-5.9552314721082231e-02,-5.8647776241232630e-02,-4.8431444361223963e-01,-4.7940697675240884e-01,-5.0377908916905167e-01,-5.0382968624369817e-01,-9.5874190111141844e-02,-1.9421407674212815e-01,-3.0096975286255689e-01,

8,15
7.2756321097537813e-01,1.0550180275865639e+00,1.2934377169552664e-02,1.5840569813655045e-02,1.6182844443889951e-02,1.0674028127470643e+00,8.4506304866475736e-03,1.0809166887976869e-02,9.0865213209965299e-03,3.6477278466257951e-01,3.9607845597594227e-01,4.0902194206218490e-01,1.0451400269829970e-03,4.3591488705698950e-03,2.2679738907597880e-02,
8.9413519380986917e-01,1.0560662842085811e+00,1.8536545357606148e-02,1.9581733518310440e-02,2.0301506504884638e-02,1.0682259004383043e+00,5.0202296832611406e-03,1.6111487633101242e-02,9.6066103213892258e-03,5.8826033969497545e-02,4.2378735073468787e-01,4.5417207744658744e-01,3.2968948481375399e-01,6.1858607603854756e-03,3.2992202120989383e-02,
1.0501087863287473e+00,1.0560496845791525e+00,1.8653874159069415e-02,1.8999729135510034e-02,1.8229450332315825e-02,1.0682037640439832e+00,2.0313524975009260e-02,1.1520057521026857e-02,1.2706335521772050e-02,4.1520356466872360e-01,1.2109403260675666e-01,4.8787225621964564e-01,2.0061009330242818e-03,3.8337757076437590e-01,4.7569806222174750e-02,
1.1669486989535107e+00,1.0556357884214096e+00,1.6143879599218845e-02,1.9706797881645179e-02,2.1131556530214198e-02,1.1704465314363852e+00,1.9409320838911226e-02,1.4303128489852948e-02,1.3106770227938767e-02,6.0456858959458348e-02,1.2084561700089892e-01,5.0301691043046337e-01,4.2273392301431750e-01,4.3357261858925666e-01,6.8442203167647403e-02,
1.2052511221087376e+00,1.0558049669491916e+00,1.7697112757197864e-02,1.6310445706592000e-02,2.1633230552186137e-02,1.2074407822741977e+00,1.9116124471504396e-02,1.3761771266444220e-02,1.1119870236253899e-02,4.6307425001958546e-01,4.6378686188591428e-01,1.9032517964649368e-01,3.0240842791408222e-03,1.3433679919088603e-02,4.6081016959439502e-01,
1.2594430690832215e+00,1.0553785432946465e+00,1.6471971163834101e-02,1.6641223116072926e-02,2.0761938708242219e-02,1.2598494982513873e+00,9.5963598901091240e-02,1.3488884941211077e-02,4.2196652670851001e-02,6.0755587177327486e-02,5.0557484324803870e-01,1.9061653385771421e-01,5.1559949418754725e-01,1.9215434633325843e-02,5.0843889197497139e-01,
1.2828035280158707e+00,1.0544677961391058e+00,1.9017807427995838e-02,1.9962782649976231e-02,2.1115847432360238e-02,1.2823604427155004e+00,5.5733045187864400e-02,7.5926857736812792e-02,4.1690980408634268e-02,4.7836639412568882e-01,1.2261497491272529e-01,1.8982799126909944e-01,5.9348670583034393e-03,5.5563681366372442e-01,5.2610616126186738e-01,
1.2913870162290366e+00,1.0527777666054547e+00,1.8253008016587299e-02,1.8762441680862173e-02,2.1566962323902684e-02,1.2906371652443700e+00,2.0513368284839256e-01,8.0329709295348972e-01,3.8207431069901415e-01,6.1254831558177049e-02,1.2338194014105409e-01,1.9191561714853278e-01,5.5964223546264535e-01,6.0912830517568539e-01,5.9118153347702052e-01,

