1
1
15
0
(8 0
((0,0,0) (7,7,7) (0,0,0))
((8,0,0) (15,7,7) (0,0,0))
((0,8,0) (7,15,7) (0,0,0))
((8,8,0) (15,15,7) (0,0,0))
((0,0,8) (7,7,15) (0,0,0))
((8,0,8) (15,7,15) (0,0,0))
((0,8,8) (7,15,15) (0,0,0))
((8,8,8) (15,15,15) (0,0,0))
)
8
FabOnDisk: Cell_D_00000 0
FabOnDisk: Cell_D_00000 61527
FabOnDisk: Cell_D_00000 123055
FabOnDisk: Cell_D_00000 184583
FabOnDisk: Cell_D_00000 246112
FabOnDisk: Cell_D_00000 307640
FabOnDisk: Cell_D_00000 369169
FabOnDisk: Cell_D_00000 430698

8,15
1.23847851605002838e-02,7.35377128903288296e-02,-1.53343053306253772e-02,-1.39771424387024126e-02,-1.22435797778093283e-02,6.30874271929223518e-01,-2.88887861141985235e-03,-1.82009477219520531e-03,-3.69905757694361534e-04,-9.42055749830006395e-03,-3.79315502109521807e-02,-1.41356759430894791e-01,-3.33223026013365176e-01,-3.71767380069454589e-01,-4.48512450086264725e-01,
1.21468029118867605e-02,3.28228151362316076e-02,-1.00469853423922409e-02,-1.45300240959289739e-02,-1.16425282314660487e-02,6.32084398970528927e-01,-6.93159897989193731e-03,-1.79197174241079544e-03,-7.17217486195212157e-04,-3.55689029499176357e-01,-5.07583221563238443e-02,-1.81639620051216255e-01,-9.31904191061785625e-02,-4.35733914842211245e-01,-4.83866420872347658e-01,
1.21540794648306253e-02,1.11514845331218884e-02,-1.32778156101129082e-02,-1.03608068619521695e-02,-1.08806157159685758e-02,6.29725822002472624e-01,-2.82587067379817336e-03,-9.72678187321724189e-03,-1.69035306090018211e-02,-1.70218074296613620e-02,-3.92651227291890337e-01,-2.30142203995726713e-01,-4.16132544832290174e-01,-1.87958973741995355e-01,-5.58511703657215031e-01,
1.21852123226465908e-02,3.49783248287447238e-03,-1.63033855268209446e-02,-1.51274271572691982e-02,-1.29862307993701201e-02,6.27886959102936126e-01,-1.78075611238606782e-02,-1.34277072413950781e-02,-5.06131033961945836e-02,-4.22941037833801103e-01,-4.02718831590744841e-01,-2.86380855746242446e-01,-9.26985510473584962e-02,-1.86733244873462212e-01,-6.08379586995333455e-01,
1.21807806914893280e-02,2.18966016546015812e-03,-1.33540552482267361e-02,-1.45764117220092658e-02,-1.28217954972376733e-02,6.28724928548964668e-01,-2.92627288259458959e-03,-3.00849791214966023e-02,-5.14511308620355622e-03,-2.48979494589409885e-02,-9.82910246054213982e-02,-4.33315515179347299e-01,-5.10738724822690782e-01,-5.17609509574546989e-01,-2.93701863551052433e-01,
1.22122955309158319e-02,4.06429168165837248e-04,-1.43869048872511916e-02,-1.33608085768002951e-02,-1.19093109064165627e-02,6.29110006212327377e-01,-8.10376822642396855e-02,-1.28130930473920240e-01,-1.83720609843360458e-02,-4.58497545644828475e-01,-1.28704079702195412e-01,-4.41172107866329655e-01,-9.38074505858665919e-02,-5.95210723477861636e-01,-3.00342842711213032e-01,
1.23140150271359161e-02,-4.43085300370265353e-04,-1.50236274722693290e-02,-1.18178210353122246e-02,-1.09221290415377949e-02,6.29975501220333078e-01,-3.64321623373607476e-02,-2.28076330309409658e-02,-7.34365293030988520e-02,-4.38671946236363075e-02,-4.86158738020149417e-01,-4.58683992232635451e-01,-5.82795725869591497e-01,-1.91489853042240699e-01,-2.99696889963862012e-01,
1.24206147057495629e-02,-8.37361003956147917e-04,-1.70183959246209028e-02,-1.21272442022662859e-02,-1.44439730059887726e-02,6.29012122664968754e-01,-5.95523147210822307e-02,-5.86477762412326298e-02,-4.84314443612239631e-01,-4.79406976752408842e-01,-5.03779089169051675e-01,-5.03829686243698172e-01,-9.58741901111418438e-02,-1.94214076742128150e-01,-3.00969752862556894e-01,

8,15
7.27563210975378127e-01,1.05501802758656393e+00,1.29343771695526639e-02,1.58405698136550449e-02,1.61828444438899509e-02,1.06740281274706428e+00,8.45063048664757357e-03,1.08091668879768694e-02,9.08652132099652989e-03,3.64772784662579508e-01,3.96078455975942267e-01,4.09021942062184896e-01,1.04514002698299696e-03,4.35914887056989501e-03,2.26797389075978802e-02,
8.94135193809869167e-01,1.05606628420858106e+00,1.85365453576061476e-02,1.95817335183104402e-02,2.03015065048846380e-02,1.06822590043830434e+00,5.02022968326114056e-03,1.61114876331012423e-02,9.60661032138922580e-03,5.88260339694975445e-02,4.23787350734687873e-01,4.54172077446587441e-01,3.29689484813753986e-01,6.18586076038547556e-03,3.29922021209893834e-02,
1.05010878632874727e+00,1.05604968457915249e+00,1.86538741590694147e-02,1.89997291355100337e-02,1.82294503323158254e-02,1.06820376404398321e+00,2.03135249750092603e-02,1.15200575210268573e-02,1.27063355217720501e-02,4.15203564668723601e-01,1.21094032606756663e-01,4.87872256219645639e-01,2.00610093302428178e-03,3.83377570764375897e-01,4.75698062221747500e-02,
1.16694869895351072e+00,1.05563578842140959e+00,1.61438795992188446e-02,1.97067978816451786e-02,2.11315565302141982e-02,1.17044653143638522e+00,1.94093208389112259e-02,1.43031284898529482e-02,1.31067702279387670e-02,6.04568589594583483e-02,1.20845617000898922e-01,5.03016910430463371e-01,4.22733923014317503e-01,4.33572618589256664e-01,6.84422031676474030e-02,
1.20525112210873764e+00,1.05580496694919157e+00,1.76971127571978644e-02,1.63104457065920000e-02,2.16332305521861369e-02,1.20744078227419771e+00,1.91161244715043963e-02,1.37617712664442199e-02,1.11198702362538988e-02,4.63074250019585465e-01,4.63786861885914281e-01,1.90325179646493675e-01,3.02408427914082224e-03,1.34336799190886026e-02,4.60810169594395025e-01,
1.25944306908322146e+00,1.05537854329464653e+00,1.64719711638341010e-02,1.66412231160729257e-02,2.07619387082422190e-02,1.25984949825138726e+00,9.59635989010912405e-02,1.34888849412110774e-02,4.21966526708510009e-02,6.07555871773274858e-02,5.05574843248038697e-01,1.90616533857714210e-01,5.15599494187547247e-01,1.92154346333258431e-02,5.08438891974971385e-01,
1.28280352801587072e+00,1.05446779613910580e+00,1.90178074279958378e-02,1.99627826499762309e-02,2.11158474323602380e-02,1.28236044271550043e+00,5.57330451878643995e-02,7.59268577368127917e-02,4.16909804086342678e-02,4.78366394125688821e-01,1.22614974912725286e-01,1.89827991269099439e-01,5.93486705830343925e-03,5.55636813663724416e-01,5.26106161261867378e-01,
1.29138701622903662e+00,1.05277776660545475e+00,1.82530080165872986e-02,1.87624416808621734e-02,2.15669623239026845e-02,1.29063716524437000e+00,2.05133682848392562e-01,8.03297092953489722e-01,3.82074310699014152e-01,6.12548315581770489e-02,1.23381940141054094e-01,1.91915617148532780e-01,5.59642235462645354e-01,6.09128305175685392e-01,5.91181533477020515e-01,

