1
1
15
0
(8 0
((0,0,0) (7,7,7) (0,0,0))
((8,0,0) (15,7,7) (0,0,0))
((0,8,0) (7,15,7) (0,0,0))
((8,8,0) (15,15,7) (0,0,0))
((0,0,8) (7,7,15) (0,0,0))
((8,0,8) (15,7,15) (0,0,0))
((0,8,8) (7,15,15) (0,0,0))
((8,8,8) (15,15,15) (0,0,0))
)
8
FabOnDisk: Cell_D_00000 0
FabOnDisk: Cell_D_00000 61527
FabOnDisk: Cell_D_00000 123055
FabOnDisk: Cell_D_00000 184583
FabOnDisk: Cell_D_00000 246112
FabOnDisk: Cell_D_00000 307640
FabOnDisk: Cell_D_00000 369169
FabOnDisk: Cell_D_00000 430698

8,15
1.2390537950856689e-02,7.7501652745843558e-02,-1.5347746843723432e-02,-1.3886504223704504e-02,-1.2522316241979064e-02,6.3085404724377026e-01,-2.8886228285345140e-03,-1.9976374448490960e-03,-5.0264599755800985e-04,-9.3901818670483004e-03,-3.8183840897355895e-02,-1.4344070629373445e-01,-3.2975097699942135e-01,-3.6736687956096703e-01,-4.4882550430159196e-01,
1.2149707279700462e-02,3.4779416879048453e-02,-9.9969014380559724e-03,-1.4541055290705880e-02,-1.1913865016755530e-02,6.3158710260587814e-01,-6.6628152539327523e-03,-1.8155242561145534e-03,-7.4641258410441177e-04,-3.5451024926627267e-01,-5.1252412642625700e-02,-1.8462846584018358e-01,-9.4309689673219010e-02,-4.3280237652533993e-01,-4.7982293601735038e-01,
1.2157411227400444e-02,1.1852741163077071e-02,-1.3233869853281149e-02,-1.0523152616180231e-02,-1.1192835235856917e-02,6.3001204504159791e-01,-2.9319413702964705e-03,-9.7130152649698431e-03,-1.5290245440379817e-02,-1.7061941864781566e-02,-3.9119551366344912e-01,-2.3411400485245362e-01,-4.1575461831366012e-01,-1.9046005939128952e-01,-5.5659290555937946e-01,
1.2189319820792303e-02,3.6634628193893213e-03,-1.6398689811992440e-02,-1.5325677109156064e-02,-1.3070119050533961e-02,6.2788872586346789e-01,-1.8314874576252548e-02,-1.3845913444806141e-02,-5.1210848589250610e-02,-4.2165032049245116e-01,-4.0140483747808858e-01,-2.9148332658885168e-01,-9.3899456780360852e-02,-1.8926580523069375e-01,-6.0908983117565652e-01,
1.2181194539588106e-02,2.2592043363958638e-03,-1.3361369781339373e-02,-1.4624274450631801e-02,-1.3179480784602063e-02,6.2873946094727673e-01,-2.9215376697998376e-03,-3.0852136593105463e-02,-5.0581505834234111e-03,-2.5111179209646801e-02,-1.0002645186095444e-01,-4.3195916133796192e-01,-5.0909113783587379e-01,-5.1930170971128864e-01,-2.9545150828711153e-01,
1.2213519101273485e-02,4.3033695272812970e-04,-1.4408613350762042e-02,-1.3341258882697875e-02,-1.2290520015058830e-02,6.2898297266730940e-01,-7.7485485159975720e-02,-1.1805740485493732e-01,-1.8175917943861683e-02,-4.5795175964774371e-01,-1.3125922412708174e-01,-4.3915073379073882e-01,-9.4940534280475553e-02,-5.9413107549138844e-01,-3.0273121757451038e-01,
1.2316431904753618e-02,-4.4358012866563539e-04,-1.5128878862731213e-02,-1.2080616799822303e-02,-1.1317642366643546e-02,6.2989941932504334e-01,-3.6906044452969432e-02,-2.3334371750924707e-02,-5.0961379613433930e-02,-4.4474801323945212e-02,-4.8615210536056475e-01,-4.6056887680994985e-01,-5.8394802189791251e-01,-1.9340279392040940e-01,-3.0235811808501317e-01,
1.2427359787635940e-02,-8.4193602980445204e-04,-1.7059856208913964e-02,-1.2380306016801243e-02,-1.4594393289884123e-02,6.2906225237160340e-01,-6.6292659456996750e-02,-7.8055598724143901e-02,-4.1316817005765044e-01,-4.8034805670651465e-01,-5.0292663345033284e-01,-5.0509477586160811e-01,-9.6840683963730689e-02,-1.9613458025457864e-01,-3.0366607090668463e-01,

8,15
7.1520414753093808e-01,1.0549928401776574e+00,1.2810874895850441e-02,1.5726717517024005e-02,1.5997288996576434e-02,1.0673833781285140e+00,8.0785521564373849e-03,1.0449132386609300e-02,8.8312942422951683e-03,3.6383447123484658e-01,3.9390763363295039e-01,4.0526936422583226e-01,1.0420427938320552e-03,4.3926710417352497e-03,2.3241587477409249e-02,
8.8385222559491117e-01,1.0560540971338375e+00,1.8456094777682744e-02,1.9505518785795810e-02,2.0068561348789614e-02,1.0682201877240474e+00,4.9623122983587405e-03,1.6023033889794744e-02,9.3490328452228745e-03,5.9322068206045443e-02,4.2318698964828988e-01,4.5192992323312353e-01,3.2636882935173700e-01,6.2557665755381244e-03,3.3944983220103919e-02,
1.0427170872435130e+00,1.0560376919507450e+00,1.8559493786705496e-02,1.8623804053728522e-02,1.8050202755538348e-02,1.0681951031781456e+00,2.0582573444036158e-02,1.1550830984909850e-02,1.2410190457343612e-02,4.1279558888046619e-01,1.2242908875509979e-01,4.8736555056541120e-01,2.0089661418083871e-03,3.8057000659550366e-01,4.9101249401052038e-02,
1.1628560230703016e+00,1.0556163998332686e+00,1.5988426686402327e-02,1.9365019692157093e-02,2.0876397215230540e-02,1.1665194858896908e+00,1.9321796346473033e-02,1.4873032010934147e-02,1.2809323350681974e-02,6.1135431014472719e-02,1.2225739758844517e-01,5.0427579331439054e-01,4.2013796691183419e-01,4.3131525884233379e-01,7.0887355613772560e-02,
1.2030231205940680e+00,1.0558143592261862e+00,1.7626359425989689e-02,1.6366573624765401e-02,2.1501708759115355e-02,1.2052823249304638e+00,1.8743725789083843e-02,1.3747624596716645e-02,1.0870818143699709e-02,4.6263471001488760e-01,4.6196468333684609e-01,1.9199863823857921e-01,3.0484122593993166e-03,1.3730534780033410e-02,4.5924545929120991e-01,
1.2587947724495590e+00,1.0553813480447054e+00,1.6340556590818942e-02,1.6700685853206474e-02,2.0565504644386022e-02,1.2592251094022870e+00,9.1466943412026408e-02,1.3582948462355110e-02,3.8659811062677157e-02,6.1383842824090665e-02,5.0499798099925663e-01,1.9241158433779121e-01,5.1463641825773954e-01,1.9721500519900528e-02,5.0657964361565266e-01,
1.2827233499811206e+00,1.0544646458963365e+00,1.8937489095780531e-02,1.9670720294807521e-02,2.0908364023517801e-02,1.2822797698524548e+00,5.1053283469688716e-02,8.6765718660723745e-02,4.0155857367796643e-02,4.7900009217788930e-01,1.2386126993654736e-01,1.9144303854280054e-01,6.0161918392100805e-03,5.5608067437343511e-01,5.2303535550018221e-01,
1.2914122939525132e+00,1.0527308934028765e+00,1.8185404902215575e-02,1.8333578536348649e-02,2.1380950312789200e-02,1.2906646309420495e+00,3.1300026570372064e-01,1.0958217359433746e+00,4.9798854120499408e-01,6.1952398265140013e-02,1.2449580993893841e-01,1.9361683302101496e-01,5.5876665546148141e-01,6.0882977690445483e-01,5.9357005189861256e-01,

