1
1
15
0
(8 0
((0,0,0) (7,7,7) (0,0,0))
((8,0,0) (15,7,7) (0,0,0))
((0,8,0) (7,15,7) (0,0,0))
((8,8,0) (15,15,7) (0,0,0))
((0,0,8) (7,7,15) (0,0,0))
((8,0,8) (15,7,15) (0,0,0))
((0,8,8) (7,15,15) (0,0,0))
((8,8,8) (15,15,15) (0,0,0))
)
8
FabOnDisk: Cell_D_00000 0
FabOnDisk: Cell_D_00000 61527
FabOnDisk: Cell_D_00000 123055
FabOnDisk: Cell_D_00000 184583
FabOnDisk: Cell_D_00000 246112
FabOnDisk: Cell_D_00000 307640
FabOnDisk: Cell_D_00000 369169
FabOnDisk: Cell_D_00000 430698

8,15
1.23905379508566886e-02,7.75016527458435578e-02,-1.53477468437234321e-02,-1.38865042237045037e-02,-1.25223162419790639e-02,6.30854047243770255e-01,-2.88862282853451398e-03,-1.99763744484909595e-03,-5.02645997558009852e-04,-9.39018186704830039e-03,-3.81838408973558946e-02,-1.43440706293734455e-01,-3.29750976999421352e-01,-3.67366879560967030e-01,-4.48825504301591960e-01,
1.21497072797004616e-02,3.47794168790484526e-02,-9.99690143805597245e-03,-1.45410552907058802e-02,-1.19138650167555302e-02,6.31587102605878137e-01,-6.66281525393275231e-03,-1.81552425611455339e-03,-7.46412584104411765e-04,-3.54510249266272670e-01,-5.12524126426256998e-02,-1.84628465840183581e-01,-9.43096896732190104e-02,-4.32802376525339927e-01,-4.79822936017350377e-01,
1.21574112274004439e-02,1.18527411630770709e-02,-1.32338698532811494e-02,-1.05231526161802310e-02,-1.11928352358569173e-02,6.30012045041597912e-01,-2.93194137029647054e-03,-9.71301526496984313e-03,-1.52902454403798169e-02,-1.70619418647815664e-02,-3.91195513663449124e-01,-2.34114004852453622e-01,-4.15754618313660118e-01,-1.90460059391289516e-01,-5.56592905559379458e-01,
1.21893198207923027e-02,3.66346281938932129e-03,-1.63986898119924396e-02,-1.53256771091560638e-02,-1.30701190505339605e-02,6.27888725863467889e-01,-1.83148745762525475e-02,-1.38459134448061412e-02,-5.12108485892506099e-02,-4.21650320492451158e-01,-4.01404837478088583e-01,-2.91483326588851677e-01,-9.38994567803608515e-02,-1.89265805230693751e-01,-6.09089831175656515e-01,
1.21811945395881062e-02,2.25920433639586376e-03,-1.33613697813393731e-02,-1.46242744506318006e-02,-1.31794807846020625e-02,6.28739460947276729e-01,-2.92153766979983765e-03,-3.08521365931054628e-02,-5.05815058342341112e-03,-2.51111792096468008e-02,-1.00026451860954435e-01,-4.31959161337961917e-01,-5.09091137835873786e-01,-5.19301709711288639e-01,-2.95451508287111531e-01,
1.22135191012734852e-02,4.30336952728129700e-04,-1.44086133507620416e-02,-1.33412588826978748e-02,-1.22905200150588301e-02,6.28982972667309403e-01,-7.74854851599757199e-02,-1.18057404854937320e-01,-1.81759179438616830e-02,-4.57951759647743706e-01,-1.31259224127081742e-01,-4.39150733790738823e-01,-9.49405342804755525e-02,-5.94131075491388438e-01,-3.02731217574510381e-01,
1.23164319047536185e-02,-4.43580128665635389e-04,-1.51288788627312130e-02,-1.20806167998223028e-02,-1.13176423666435464e-02,6.29899419325043342e-01,-3.69060444529694318e-02,-2.33343717509247074e-02,-5.09613796134339297e-02,-4.44748013239452122e-02,-4.86152105360564746e-01,-4.60568876809949845e-01,-5.83948021897912506e-01,-1.93402793920409405e-01,-3.02358118085013172e-01,
1.24273597876359398e-02,-8.41936029804452035e-04,-1.70598562089139642e-02,-1.23803060168012433e-02,-1.45943932898841226e-02,6.29062252371603403e-01,-6.62926594569967498e-02,-7.80555987241439014e-02,-4.13168170057650441e-01,-4.80348056706514648e-01,-5.02926633450332838e-01,-5.05094775861608114e-01,-9.68406839637306893e-02,-1.96134580254578639e-01,-3.03666070906684626e-01,

8,15
7.15204147530938084e-01,1.05499284017765738e+00,1.28108748958504406e-02,1.57267175170240046e-02,1.59972889965764344e-02,1.06738337812851403e+00,8.07855215643738488e-03,1.04491323866093000e-02,8.83129424229516825e-03,3.63834471234846579e-01,3.93907633632950394e-01,4.05269364225832263e-01,1.04204279383205518e-03,4.39267104173524971e-03,2.32415874774092486e-02,
8.83852225594911167e-01,1.05605409713383747e+00,1.84560947776827439e-02,1.95055187857958098e-02,2.00685613487896139e-02,1.06822018772404737e+00,4.96231229835874046e-03,1.60230338897947439e-02,9.34903284522287450e-03,5.93220682060454432e-02,4.23186989648289880e-01,4.51929923233123532e-01,3.26368829351737000e-01,6.25576657553812438e-03,3.39449832201039192e-02,
1.04271708724351297e+00,1.05603769195074504e+00,1.85594937867054957e-02,1.86238040537285224e-02,1.80502027555383485e-02,1.06819510317814559e+00,2.05825734440361584e-02,1.15508309849098496e-02,1.24101904573436124e-02,4.12795588880466191e-01,1.22429088755099794e-01,4.87365550565411199e-01,2.00896614180838713e-03,3.80570006595503663e-01,4.91012494010520384e-02,
1.16285602307030156e+00,1.05561639983326860e+00,1.59884266864023274e-02,1.93650196921570927e-02,2.08763972152305397e-02,1.16651948588969079e+00,1.93217963464730330e-02,1.48730320109341473e-02,1.28093233506819740e-02,6.11354310144727187e-02,1.22257397588445171e-01,5.04275793314390541e-01,4.20137966911834193e-01,4.31315258842333793e-01,7.08873556137725597e-02,
1.20302312059406802e+00,1.05581435922618616e+00,1.76263594259896891e-02,1.63665736247654015e-02,2.15017087591153552e-02,1.20528232493046383e+00,1.87437257890838427e-02,1.37476245967166448e-02,1.08708181436997092e-02,4.62634710014887596e-01,4.61964683336846094e-01,1.91998638238579211e-01,3.04841225939931661e-03,1.37305347800334102e-02,4.59245459291209912e-01,
1.25879477244955895e+00,1.05538134804470540e+00,1.63405565908189415e-02,1.67006858532064741e-02,2.05655046443860220e-02,1.25922510940228705e+00,9.14669434120264080e-02,1.35829484623551100e-02,3.86598110626771574e-02,6.13838428240906647e-02,5.04997980999256635e-01,1.92411584337791208e-01,5.14636418257739536e-01,1.97215005199005283e-02,5.06579643615652664e-01,
1.28272334998112059e+00,1.05446464589633648e+00,1.89374890957805311e-02,1.96707202948075213e-02,2.09083640235178010e-02,1.28227976985245484e+00,5.10532834696887164e-02,8.67657186607237452e-02,4.01558573677966435e-02,4.79000092177889303e-01,1.23861269936547364e-01,1.91443038542800537e-01,6.01619183921008049e-03,5.56080674373435113e-01,5.23035355500182209e-01,
1.29141229395251322e+00,1.05273089340287651e+00,1.81854049022155753e-02,1.83335785363486492e-02,2.13809503127892001e-02,1.29066463094204953e+00,3.13000265703720637e-01,1.09582173594337462e+00,4.97988541204994084e-01,6.19523982651400129e-02,1.24495809938938412e-01,1.93616833021014956e-01,5.58766655461481410e-01,6.08829776904454834e-01,5.93570051898612561e-01,

