1
1
15
0
(8 0
((0,0,0) (7,7,7) (0,0,0))
((8,0,0) (15,7,7) (0,0,0))
((0,8,0) (7,15,7) (0,0,0))
((8,8,0) (15,15,7) (0,0,0))
((0,0,8) (7,7,15) (0,0,0))
((8,0,8) (15,7,15) (0,0,0))
((0,8,8) (7,15,15) (0,0,0))
((8,8,8) (15,15,15) (0,0,0))
)
8
FabOnDisk: Cell_D_00000 0
FabOnDisk: Cell_D_00000 61527
FabOnDisk: Cell_D_00000 123055
FabOnDisk: Cell_D_00000 184583
FabOnDisk: Cell_D_00000 246112
FabOnDisk: Cell_D_00000 307640
FabOnDisk: Cell_D_00000 369169
FabOnDisk: Cell_D_00000 430698

8,15
1.23912643375904390e-02,7.17879782184651510e-02,-1.54051847076370554e-02,-1.41437745811624459e-02,-1.25375378619006824e-02,6.31007286653828214e-01,-2.89767616887572728e-03,-1.84350708867136700e-03,-6.02871194024436974e-04,-9.67237987657689272e-03,-3.76789384883535888e-02,-1.39665672344802622e-01,-3.35508261946871056e-01,-3.73580598686271526e-01,-4.47603179874476009e-01,
1.21500319849445777e-02,3.14514558288848528e-02,-1.01513359602283491e-02,-1.47403727635226234e-02,-1.18585448358355765e-02,6.32714069467730122e-01,-7.11526943666510210e-03,-1.97143607845225556e-03,-1.00075310552289907e-03,-3.55668899614691114e-01,-5.05937841729708140e-02,-1.80007361711619795e-01,-9.43492548841244061e-02,-4.37878415650031494e-01,-4.86721271696888835e-01,
1.21573535440607991e-02,1.08926194840828841e-02,-1.34471633574866755e-02,-1.04288883399278644e-02,-1.11343729773222683e-02,6.29728871784967836e-01,-2.79706540752573804e-03,-9.75618704650466073e-03,-1.75950923891809996e-02,-1.74191769437136608e-02,-3.93280278883719636e-01,-2.27050764144316242e-01,-4.17539625992699615e-01,-1.86502957322441487e-01,-5.58679306166893541e-01,
1.21889255360716625e-02,3.37718447068937298e-03,-1.63610066184731624e-02,-1.51192695110417916e-02,-1.33693009031740067e-02,6.27861249629946716e-01,-1.74290695711671120e-02,-1.31453686137653347e-02,-5.06119679618079257e-02,-4.24298113599120397e-01,-4.03426587901375866e-01,-2.83434117460110158e-01,-9.36045269083196629e-02,-1.85049523237736990e-01,-6.07909789489397223e-01,
1.21832759200192157e-02,2.18090532158227591e-03,-1.34237039609550433e-02,-1.47687008072022209e-02,-1.29823300965786689e-02,6.28636026055479080e-01,-2.97677217849403502e-03,-2.96109573373400450e-02,-5.47437909890075534e-03,-2.53311180909022160e-02,-9.68348499460858492e-02,-4.33788575447732305e-01,-5.11177803078027071e-01,-5.16466747716114338e-01,-2.92082129348635922e-01,
1.22156961522902081e-02,3.85709966815520305e-04,-1.44669979019858442e-02,-1.35579509110888095e-02,-1.19909480767882385e-02,6.29155004831607245e-01,-8.41966691142753271e-02,-1.39025501366920490e-01,-1.86980819850717794e-02,-4.58349491794638075e-01,-1.27214669596296293e-01,-4.42285996092338762e-01,-9.47986564812326737e-02,-5.96099424227525820e-01,-2.98616034370112193e-01,
1.23143607070054194e-02,-4.41484302576851287e-04,-1.50742210295377599e-02,-1.20788972900296356e-02,-1.10264447062442851e-02,6.29969926356228949e-01,-3.69938903160621918e-02,-2.27127819645141227e-02,-8.05926475625974165e-02,-4.44672112324872720e-02,-4.85698992102683080e-01,-4.56705602967109936e-01,-5.83937519500550062e-01,-1.90235880493912712e-01,-2.97678245967448796e-01,
1.24219476854010961e-02,-8.35955303162954797e-04,-1.70633960344498126e-02,-1.22811422055468210e-02,-1.46570813517630186e-02,6.29059224197555444e-01,-5.66642103762867097e-02,-5.21373671432628472e-01,-4.32068019619732890e+00,-4.80281007284559247e-01,-5.04283874591746395e-01,-5.02991761768684431e-01,-9.68078419022204151e-02,-1.92942587880861743e-01,-2.98870108459134420e-01,

8,15
7.33259869996242597e-01,1.05499070211156409e+00,1.28261715541817065e-02,1.55687093200457538e-02,1.58781762913357549e-02,1.06738196644915462e+00,8.54660094304191854e-03,1.09221567630124299e-02,9.01562317487130185e-03,3.65793431956485282e-01,3.96858611472356959e-01,4.10565443927760843e-01,1.07190927270289999e-03,4.32555371407000039e-03,2.22563384289450224e-02,
9.01712762345639351e-01,1.05605023220674221e+00,1.84780460747344319e-02,1.93752828363028921e-02,2.01251844295262661e-02,1.06821063287607720e+00,4.91682948010583546e-03,1.61206336030430275e-02,9.55624826829190067e-03,5.96773322624557095e-02,4.24148313725277393e-01,4.55621308999667796e-01,3.31557507097841320e-01,6.16247664030507292e-03,3.24924837964062074e-02,
1.05301650293229154e+00,1.05604340060433577e+00,1.85564703261221937e-02,1.89687052413156157e-02,1.80582677127855799e-02,1.06820075414839666e+00,1.98099377948646183e-02,1.12294224766994293e-02,1.26601978552252255e-02,4.15933109626575537e-01,1.20261279981592972e-01,4.87629891749345346e-01,2.05276698230839796e-03,3.84422657020094427e-01,4.64566401094286263e-02,
1.17022884199986543e+00,1.05561905432304615e+00,1.61477324830738636e-02,1.96789633913427194e-02,2.09059828833291009e-02,1.17360602647055479e+00,1.94578596001638779e-02,1.35966735755898536e-02,1.29146368361111926e-02,6.11399356770477437e-02,1.19855844781192517e-01,5.01947612844625968e-01,4.25615956644428250e-01,4.35154978617907418e-01,6.70887250014923775e-02,
1.20553514268241369e+00,1.05580429168790335e+00,1.76402535258763996e-02,1.63308158078413861e-02,2.13197758846081879e-02,1.20771604800399590e+00,1.91163059860503734e-02,1.38183307079237927e-02,1.10760337681036960e-02,4.63405170756276796e-01,4.64174820432172286e-01,1.89087909404650284e-01,3.07664697108349242e-03,1.31882757530616904e-02,4.60837523994627185e-01,
1.25995632183823170e+00,1.05536994629354464e+00,1.64223614119104744e-02,1.64377059988741608e-02,2.03580366958210739e-02,1.26034203180504711e+00,9.78301015610757996e-02,1.32119433228691120e-02,4.35060323135167057e-02,6.13461995281220501e-02,5.06000587238387478e-01,1.89259305419656548e-01,5.16274798768189158e-01,1.89326682072059535e-02,5.09573053797288122e-01,
1.28272451592961212e+00,1.05448858514876376e+00,1.89025127636934000e-02,1.99544932101705097e-02,2.06980909918611927e-02,1.28228303162703527e+00,5.31974369990304424e-02,5.54970978828821099e-02,4.21670394393304365e-02,4.79023774550226045e-01,1.21802803699977313e-01,1.88452744824571111e-01,6.01344370770227898e-03,5.54260141214063862e-01,5.27837633268130046e-01,
1.29143771899758564e+00,1.05278930652214164e+00,1.81537487338949456e-02,1.86966898014449441e-02,2.11960272649723003e-02,1.29069620529326401e+00,1.46032639854464086e+00,8.63548003218262084e-01,4.15774818055012985e-01,6.18370083424163303e-02,1.22500703418615270e-01,1.90560217751381211e-01,5.58707059567654207e-01,6.09330602129806054e-01,5.89777945180777641e-01,

