1
1
15
0
(8 0
((0,0,0) (7,7,7) (0,0,0))
((8,0,0) (15,7,7) (0,0,0))
((0,8,0) (7,15,7) (0,0,0))
((8,8,0) (15,15,7) (0,0,0))
((0,0,8) (7,7,15) (0,0,0))
((8,0,8) (15,7,15) (0,0,0))
((0,8,8) (7,15,15) (0,0,0))
((8,8,8) (15,15,15) (0,0,0))
)
8
FabOnDisk: Cell_D_00000 0
FabOnDisk: Cell_D_00000 61527
FabOnDisk: Cell_D_00000 123055
FabOnDisk: Cell_D_00000 184583
FabOnDisk: Cell_D_00000 246112
FabOnDisk: Cell_D_00000 307640
FabOnDisk: Cell_D_00000 369169
FabOnDisk: Cell_D_00000 430698

8,15
1.13459288791339531e-02,3.64174086583031334e-03,-1.43926732509121469e-02,-1.08875644706491297e-02,-8.47114898196286645e-03,6.27452477708804190e-01,-1.53761687993805374e-03,-1.12973972528733792e-02,-1.96518769450317356e-02,-1.03654225179492694e-02,-2.67990080174951642e-02,-5.34465396036193155e-02,-4.75464500295049497e-01,-4.86406455451315722e-01,-4.87882380201400512e-01,
1.11638505600637535e-02,1.66950963135440019e-03,-7.50428434865669115e-03,-9.70767520713205524e-03,-7.00195199865353592e-03,6.28237666569318454e-01,-2.50194488792284987e-02,-5.64187482711931733e-03,-9.49203002378372351e-03,-4.32528048449731140e-01,-3.25335768602429756e-02,-6.43894932592387198e-02,-4.24007418265163888e-02,-5.29902421716517247e-01,-5.41614130653590875e-01,
1.13446256549680144e-02,1.08386127040387809e-03,-1.57061449527292063e-02,-1.20669210463188962e-03,-5.37086735448647629e-03,6.28903928070091989e-01,-3.81018095832747405e-03,-6.55038141161160079e-03,-1.52878275675055204e-02,-1.41960187125968473e-02,-4.49889308248768049e-01,-7.15625300736597164e-02,-5.20835957206363664e-01,-9.74061947382493798e-02,-5.68147531997312272e-01,
1.12169592486261998e-02,1.73647568549346870e-05,-9.99389966736844576e-03,-4.74455369780143847e-03,-9.06875074784204566e-03,6.27912070222225616e-01,-7.30745644769227043e-02,-6.67328143787655703e-01,-4.37935387835630419e+00,-4.68829973261258193e-01,-4.55460173480005059e-01,-8.59491785945898645e-02,-4.69367797779260201e-02,-1.00387009910950814e-01,-6.08659628231325134e-01,
1.14291567080120251e-02,2.99197631408713958e-04,-1.57033235293185872e-02,-9.91847816615732715e-03,3.05994985884024129e-05,6.28285288254349039e-01,-1.05526848847163866e-02,-6.68051952111533703e-02,-1.37573710163615796e-03,-1.61745606573694030e-02,-4.17577452779546304e-02,-4.36200236680631126e-01,-5.31159599961430029e-01,-5.73176373090239721e-01,-1.54121083263977610e-01,
1.12658523945296934e-02,-2.71486059225438175e-04,-8.10851754823426960e-03,-1.39991936031821310e-02,-4.95333740648521201e-05,6.29882209692059547e-01,-8.40604922221392492e-01,-2.86039856763654488e+00,-1.84086972693110716e-02,-4.80088079140676194e-01,-5.04288805775169879e-02,-4.69082105555720219e-01,-4.68527627466802654e-02,-5.83761221167323874e-01,-1.53825023592182808e-01,
1.15045410843258970e-02,-3.22118886895012490e-04,-1.37179728550456525e-02,-4.71198016173516969e-03,-1.03855906175477652e-03,6.26543418951042153e-01,-3.29601183396472722e-02,-1.01589820447331065e-02,-1.31374279772216909e-02,-2.20601372615812710e-02,-4.53299328236598076e-01,-4.86490555216277265e-01,-5.79364049658436686e-01,-1.00875484639708385e-01,-1.56534693612938647e-01,
1.13286262912891643e-02,-7.43833931796360290e-04,-1.21475743048547486e-02,-9.48874075784476335e-03,-1.70745475629186850e-03,6.24353093354838462e-01,-1.24712838224379924e-02,-2.12131981050772550e-02,-1.86006231480463635e-02,-4.85388385641010611e-01,-4.86887636667728219e-01,-5.09990156415091600e-01,-5.13310404363283568e-02,-1.05865445296732766e-01,-1.57905766205640230e-01,

8,15
1.17095877758759692e+00,1.05811206351833831e+00,1.75117855514036538e-02,2.23593488288275286e-02,2.70707786264058614e-02,1.17460051845342717e+00,1.56276163323421230e-02,1.54111500369144977e-02,1.91074166373720773e-02,4.41346942872017867e-01,4.56394766789765871e-01,4.58171902939307096e-01,1.19144541729885559e-03,3.13581890270542502e-03,6.40986619879580465e-03,
1.22232435622306101e+00,1.05872881308597577e+00,2.27832185611461513e-02,2.21729343140625486e-02,2.68376708929759025e-02,1.22399386585441539e+00,2.32222684962786925e-02,1.89791809650837126e-02,1.93600850629652918e-02,2.70973067679785747e-02,4.73181549307074845e-01,4.85530426484185207e-01,4.43095666388198750e-01,3.99121979612277952e-03,8.11684077067578551e-03,
1.24258387661066827e+00,1.05888047227882343e+00,1.85978458621787052e-02,2.82176345043805080e-02,2.65958859492971336e-02,1.24366773788107210e+00,5.99355760438219087e-02,2.71569956029550641e-02,1.96219122825228888e-02,4.46392587758282222e-01,6.33532223535928085e-02,4.96746296175083091e-01,1.74132090506280463e-03,4.95763609872560684e-01,9.15789146554902775e-03,
1.26572795718971420e+00,1.05837105496232264e+00,2.50305858411129616e-02,2.85031624628820125e-02,2.66066484254645387e-02,1.26574532194656908e+00,1.59668744226302639e+00,2.15524844358845169e-01,2.44255274768454059e-02,3.13303790121360198e-02,6.62449026243978750e-02,5.12524712902523882e-01,5.22242909397438781e-01,5.27945984484615161e-01,1.15561344093530072e-02,
1.26314639628858338e+00,1.05842694935574655e+00,1.74116182993807635e-02,2.17815742287005808e-02,3.61588383114694878e-02,1.26344559391999200e+00,5.24299978274162665e-02,3.96217005512198156e-02,8.66600706260971521e-02,4.46129273846875452e-01,4.80941347875365743e-01,9.90643272597204333e-02,2.02548675318203232e-03,5.30823650258143397e-03,5.03581349484141239e-01,
1.27532750633993208e+00,1.05799798827133995e+00,2.51320852043752166e-02,2.35147609870511899e-02,3.70169549468462727e-02,1.27505602028070664e+00,2.48261804213326109e-01,3.60941087411325856e-02,5.59806406929295619e-01,3.04116858496635174e-02,4.81426845045809515e-01,9.90052190786240016e-02,5.55698938998665959e-01,6.73287509177574427e-03,5.18560244029397044e-01,
1.28052632385442999e+00,1.05722102515709482e+00,1.98249360478252867e-02,3.02529216322446753e-02,3.65609071884001671e-02,1.28020420496753506e+00,5.64000555646437390e-02,7.31136067062709283e-02,1.23267189692798568e-01,4.96558161517718644e-01,6.55741514012303239e-02,1.00829752275606338e-01,2.97034746090332497e-03,5.48425165552738236e-01,5.52041650359252678e-01,
1.28572146113988106e+00,1.05652971380302141e+00,2.23708337071578459e-02,2.95424697690742089e-02,3.70968730709013497e-02,1.28497762720808462e+00,4.08085105048055341e-01,2.11983189987606263e-01,7.21106712388470683e-01,3.36795189906420739e-02,6.94030160362507087e-02,1.01895041961821059e-01,5.92710878731201096e-01,5.64136529519342345e-01,6.02031586257488205e-01,

