1
1
15
0
(8 0
((0,0,0) (7,7,7) (0,0,0))
((8,0,0) (15,7,7) (0,0,0))
((0,8,0) (7,15,7) (0,0,0))
((8,8,0) (15,15,7) (0,0,0))
((0,0,8) (7,7,15) (0,0,0))
((8,0,8) (15,7,15) (0,0,0))
((0,8,8) (7,15,15) (0,0,0))
((8,8,8) (15,15,15) (0,0,0))
)
8
FabOnDisk: Cell_D_00000 0
FabOnDisk: Cell_D_00000 61527
FabOnDisk: Cell_D_00000 123055
FabOnDisk: Cell_D_00000 184583
FabOnDisk: Cell_D_00000 246112
FabOnDisk: Cell_D_00000 307640
FabOnDisk: Cell_D_00000 369169
FabOnDisk: Cell_D_00000 430698

8,15
1.01256807290528213e-02,3.01339217098617416e-03,-2.03158884287381880e-02,-1.57133030577358002e-02,-1.04503454292386392e-02,6.26410496622127111e-01,-1.70570552219158345e-03,8.55567561563938257e-04,-1.72445511754229681e-03,-1.14758818120525383e-02,-2.58153928518635722e-02,-5.12711442038653736e-02,-4.82968019384648728e-01,-5.00599402003087723e-01,-5.11673530321491210e-01,
9.94057329220816854e-03,1.39784830381776254e-03,-8.42441772998907962e-03,-1.40205068091273193e-02,-1.07639987960301258e-02,6.25878052157194498e-01,-2.50835380467890091e-02,-1.15873044364598905e-02,-9.19924830372370432e-03,-4.44914070138733964e-01,-3.07607200300410062e-02,-6.05440546833170418e-02,-4.00517496604205561e-02,-5.34319867498074363e-01,-5.57573333882616540e-01,
1.01873589696572717e-02,1.07837600275465461e-03,-2.10031218612884325e-02,2.89596059332545425e-04,-1.19710758471104541e-02,6.28765394953531787e-01,-1.59669982560394028e-03,-7.80080130474155534e-03,-1.94042012573434758e-02,-1.48144399741154675e-02,-4.53374184110700462e-01,-6.46529223526324387e-02,-5.12469066523592032e-01,-8.22740084948110628e-02,-5.71490573050509654e-01,
9.99767074109953260e-03,1.67737367333010035e-04,-7.67203986847446624e-03,2.30882215967778259e-03,-1.74963758151837415e-02,6.27593610599771812e-01,-1.95481976603346444e-02,-2.72666942847825285e-02,-3.26546815010581359e-01,-4.70912966347157902e-01,-4.58837367607121183e-01,-7.62691121422554297e-02,-4.23075029442480793e-02,-8.05501998243367823e-02,-6.02924258641622579e-01,
1.02607226471328195e-02,3.46495304809001331e-04,-2.22099636757895763e-02,-1.66046261598148184e-02,2.63981666610101431e-03,6.27607528586311858e-01,-1.00726678048167098e-03,-3.21649825840988335e-02,-4.38751848808021511e-03,-1.65655256011693411e-02,-3.74515053236009893e-02,-4.34794842132935788e-01,-5.16444721249371907e-01,-5.59754552796890126e-01,-1.36958326937127228e-01,
1.00635430439275728e-02,-1.37908332361688012e-04,-7.22813326104205546e-03,-2.07510562125727271e-02,-1.32574190233071966e-04,6.28979444307608215e-01,-1.23598940925979228e-01,-6.63994575930037412e-01,-1.76609187656808719e-01,-4.80022439209711105e-01,-4.45276750285362177e-02,-4.66614807290207267e-01,-4.13134227031873996e-02,-5.62899334232368043e-01,-1.34111388485396194e-01,
1.03351190856871989e-02,-1.50351704047276544e-04,-1.92416430196060660e-02,-3.00514257773248374e-04,-5.37227059159893508e-05,6.26156483826968202e-01,-1.06983302004525993e+00,-6.99889248790868890e-01,-3.06030994901307696e-01,-2.13380491729200546e-02,-4.59146396407924651e-01,-4.79692326911512201e-01,-5.78537851488075905e-01,-8.50304806391307261e-02,-1.39320336553441032e-01,
1.01155779205619051e-02,-3.63656652326741024e-03,-7.86865128586573988e-03,-2.24339880416551257e-03,-6.36757847214126276e-04,6.22485313182798206e-01,-4.47249579277057066e-02,-2.29934622529276282e+02,-2.32586500763804551e+01,-4.83169978441007730e-01,-4.77096155135875055e-01,-5.04611448486949943e-01,-4.44373148177724248e-02,-8.79261364193700407e-02,-1.38062196143503846e-01,

8,15
1.18761479551616889e+00,1.06549389162218566e+00,2.01675947288488047e-02,2.21527983797011677e-02,2.93449210087838828e-02,1.19062818768715517e+00,2.82618281159058710e-02,1.58903820207903015e-02,2.07347208963864389e-02,4.39275214886622245e-01,4.61285347672026447e-01,4.74149303175309678e-01,1.32122936676123221e-03,2.97982597815718434e-03,6.12877164545081420e-03,
1.22749957336730819e+00,1.06443179014921729e+00,2.87496939124372991e-02,2.21116480310452439e-02,2.91787475694845755e-02,1.22889742167112592e+00,2.18566762061959963e-02,1.87706096734552227e-02,2.19984627898088814e-02,2.63712406384761684e-02,4.69828010224667025e-01,4.94832390354879581e-01,4.64190588255885661e-01,3.74456654060391705e-03,7.59027872934498783e-03,
1.23821174125841882e+00,1.06470824645953743e+00,2.00573521710980807e-02,3.49913266422076652e-02,2.99164598760003342e-02,1.23929011726117344e+00,6.37557662406614545e-02,1.37038686380311723e-02,3.29062113351812485e-02,4.38708740034019329e-01,5.28560197190597672e-02,4.99833831049039223e-01,1.82135683229756756e-03,4.99663679130938565e-01,8.15336889942250460e-03,
1.25734014106541059e+00,1.06379378066863861e+00,3.22539682888404872e-02,3.63074633155793108e-02,3.54825531075018408e-02,1.25750787843274359e+00,1.24198204646393071e-01,1.54837499553348024e-01,3.71750943209244733e-02,2.85268415330591774e-02,5.46725751127539739e-02,5.09677845388220030e-01,5.26224466030855265e-01,5.30067876427468221e-01,1.00626146001315548e-02,
1.25460420343406254e+00,1.06534563050757636e+00,1.97909591668152390e-02,2.13191231602657613e-02,4.66557927881356901e-02,1.25495069873887144e+00,5.09665160976696952e-02,5.17819356920160290e-02,1.23652103671257507e-01,4.58945433408209813e-01,4.70663525749113909e-01,8.93463265543032598e-02,2.05753181445137139e-03,4.66369341437466566e-03,5.06634455870506040e-01,
1.26460614588104336e+00,1.06432354346219848e+00,3.29726647380523402e-02,2.42587399162095159e-02,4.70094546007160871e-02,1.26446823754868176e+00,7.70872635839660592e-01,9.28804729040493965e-02,2.32705346923884726e-01,2.61594590246197259e-02,4.70687540341265476e-01,8.66416616591014904e-02,5.56810495848516496e-01,5.82743545370809860e-03,5.13680219714728770e-01,
1.26869043546461047e+00,1.06326474667565951e+00,1.94522975999428006e-02,3.99497697035122099e-02,4.86627112056921968e-02,1.26854008376056315e+00,3.44504707876014005e-01,4.73771406083141000e-01,5.29828215528726165e-01,4.98049856435285598e-01,5.62897402904733793e-02,9.12767223384505361e-02,2.81967427102214428e-03,5.50682756264162077e-01,5.37712326806765839e-01,
1.27254853936483969e+00,1.06208082607875598e+00,3.01392264613912428e-02,3.90197647509232665e-02,4.78306517020152949e-02,1.27202660117811295e+00,4.55325438186146911e+01,2.11037285964954480e+00,4.17605372357655469e+01,2.92249574728470074e-02,5.85213191459790366e-02,8.95936857248230412e-02,5.85573931435255046e-01,5.50826212220428602e-01,5.87609611377660546e-01,

