1
1
15
0
(8 0
((0,0,0) (7,7,7) (0,0,0))
((8,0,0) (15,7,7) (0,0,0))
((0,8,0) (7,15,7) (0,0,0))
((8,8,0) (15,15,7) (0,0,0))
((0,0,8) (7,7,15) (0,0,0))
((8,0,8) (15,7,15) (0,0,0))
((0,8,8) (7,15,15) (0,0,0))
((8,8,8) (15,15,15) (0,0,0))
)
8
FabOnDisk: Cell_D_00000 0
FabOnDisk: Cell_D_00000 61527
FabOnDisk: Cell_D_00000 123055
FabOnDisk: Cell_D_00000 184583
FabOnDisk: Cell_D_00000 246112
FabOnDisk: Cell_D_00000 307640
FabOnDisk: Cell_D_00000 369169
FabOnDisk: Cell_D_00000 430698

8,15
1.0125680729052821e-02,3.0133921709861742e-03,-2.0315888428738188e-02,-1.5713303057735800e-02,-1.0450345429238639e-02,6.2641049662212711e-01,-1.7057055221915834e-03,8.5556756156393826e-04,-1.7244551175422968e-03,-1.1475881812052538e-02,-2.5815392851863572e-02,-5.1271144203865374e-02,-4.8296801938464873e-01,-5.0059940200308772e-01,-5.1167353032149121e-01,
9.9405732922081685e-03,1.3978483038177625e-03,-8.4244177299890796e-03,-1.4020506809127319e-02,-1.0763998796030126e-02,6.2587805215719450e-01,-2.5083538046789009e-02,-1.1587304436459890e-02,-9.1992483037237043e-03,-4.4491407013873396e-01,-3.0760720030041006e-02,-6.0544054683317042e-02,-4.0051749660420556e-02,-5.3431986749807436e-01,-5.5757333388261654e-01,
1.0187358969657272e-02,1.0783760027546546e-03,-2.1003121861288433e-02,2.8959605933254542e-04,-1.1971075847110454e-02,6.2876539495353179e-01,-1.5966998256039403e-03,-7.8008013047415553e-03,-1.9404201257343476e-02,-1.4814439974115468e-02,-4.5337418411070046e-01,-6.4652922352632439e-02,-5.1246906652359203e-01,-8.2274008494811063e-02,-5.7149057305050965e-01,
9.9976707410995326e-03,1.6773736733301003e-04,-7.6720398684744662e-03,2.3088221596777826e-03,-1.7496375815183741e-02,6.2759361059977181e-01,-1.9548197660334644e-02,-2.7266694284782528e-02,-3.2654681501058136e-01,-4.7091296634715790e-01,-4.5883736760712118e-01,-7.6269112142255430e-02,-4.2307502944248079e-02,-8.0550199824336782e-02,-6.0292425864162258e-01,
1.0260722647132819e-02,3.4649530480900133e-04,-2.2209963675789576e-02,-1.6604626159814818e-02,2.6398166661010143e-03,6.2760752858631186e-01,-1.0072667804816710e-03,-3.2164982584098833e-02,-4.3875184880802151e-03,-1.6565525601169341e-02,-3.7451505323600989e-02,-4.3479484213293579e-01,-5.1644472124937191e-01,-5.5975455279689013e-01,-1.3695832693712723e-01,
1.0063543043927573e-02,-1.3790833236168801e-04,-7.2281332610420555e-03,-2.0751056212572727e-02,-1.3257419023307197e-04,6.2897944430760822e-01,-1.2359894092597923e-01,-6.6399457593003741e-01,-1.7660918765680872e-01,-4.8002243920971110e-01,-4.4527675028536218e-02,-4.6661480729020727e-01,-4.1313422703187400e-02,-5.6289933423236804e-01,-1.3411138848539619e-01,
1.0335119085687199e-02,-1.5035170404727654e-04,-1.9241643019606066e-02,-3.0051425777324837e-04,-5.3722705915989351e-05,6.2615648382696820e-01,-1.0698330200452599e+00,-6.9988924879086889e-01,-3.0603099490130770e-01,-2.1338049172920055e-02,-4.5914639640792465e-01,-4.7969232691151220e-01,-5.7853785148807590e-01,-8.5030480639130726e-02,-1.3932033655344103e-01,
1.0115577920561905e-02,-3.6365665232674102e-03,-7.8686512858657399e-03,-2.2433988041655126e-03,-6.3675784721412628e-04,6.2248531318279821e-01,-4.4724957927705707e-02,-2.2993462252927628e+02,-2.3258650076380455e+01,-4.8316997844100773e-01,-4.7709615513587506e-01,-5.0461144848694994e-01,-4.4437314817772425e-02,-8.7926136419370041e-02,-1.3806219614350385e-01,

8,15
1.1876147955161689e+00,1.0654938916221857e+00,2.0167594728848805e-02,2.2152798379701168e-02,2.9344921008783883e-02,1.1906281876871552e+00,2.8261828115905871e-02,1.5890382020790302e-02,2.0734720896386439e-02,4.3927521488662225e-01,4.6128534767202645e-01,4.7414930317530968e-01,1.3212293667612322e-03,2.9798259781571843e-03,6.1287716454508142e-03,
1.2274995733673082e+00,1.0644317901492173e+00,2.8749693912437299e-02,2.2111648031045244e-02,2.9178747569484575e-02,1.2288974216711259e+00,2.1856676206195996e-02,1.8770609673455223e-02,2.1998462789808881e-02,2.6371240638476168e-02,4.6982801022466703e-01,4.9483239035487958e-01,4.6419058825588566e-01,3.7445665406039171e-03,7.5902787293449878e-03,
1.2382117412584188e+00,1.0647082464595374e+00,2.0057352171098081e-02,3.4991326642207665e-02,2.9916459876000334e-02,1.2392901172611734e+00,6.3755766240661454e-02,1.3703868638031172e-02,3.2906211335181249e-02,4.3870874003401933e-01,5.2856019719059767e-02,4.9983383104903922e-01,1.8213568322975676e-03,4.9966367913093857e-01,8.1533688994225046e-03,
1.2573401410654106e+00,1.0637937806686386e+00,3.2253968288840487e-02,3.6307463315579311e-02,3.5482553107501841e-02,1.2575078784327436e+00,1.2419820464639307e-01,1.5483749955334802e-01,3.7175094320924473e-02,2.8526841533059177e-02,5.4672575112753974e-02,5.0967784538822003e-01,5.2622446603085526e-01,5.3006787642746822e-01,1.0062614600131555e-02,
1.2546042034340625e+00,1.0653456305075764e+00,1.9790959166815239e-02,2.1319123160265761e-02,4.6655792788135690e-02,1.2549506987388714e+00,5.0966516097669695e-02,5.1781935692016029e-02,1.2365210367125751e-01,4.5894543340820981e-01,4.7066352574911391e-01,8.9346326554303260e-02,2.0575318144513714e-03,4.6636934143746657e-03,5.0663445587050604e-01,
1.2646061458810434e+00,1.0643235434621985e+00,3.2972664738052340e-02,2.4258739916209516e-02,4.7009454600716087e-02,1.2644682375486818e+00,7.7087263583966059e-01,9.2880472904049396e-02,2.3270534692388473e-01,2.6159459024619726e-02,4.7068754034126548e-01,8.6641661659101490e-02,5.5681049584851650e-01,5.8274354537080986e-03,5.1368021971472877e-01,
1.2686904354646105e+00,1.0632647466756595e+00,1.9452297599942801e-02,3.9949769703512210e-02,4.8662711205692197e-02,1.2685400837605632e+00,3.4450470787601400e-01,4.7377140608314100e-01,5.2982821552872617e-01,4.9804985643528560e-01,5.6289740290473379e-02,9.1276722338450536e-02,2.8196742710221443e-03,5.5068275626416208e-01,5.3771232680676584e-01,
1.2725485393648397e+00,1.0620808260787560e+00,3.0139226461391243e-02,3.9019764750923266e-02,4.7830651702015295e-02,1.2720266011781129e+00,4.5532543818614691e+01,2.1103728596495448e+00,4.1760537235765547e+01,2.9224957472847007e-02,5.8521319145979037e-02,8.9593685724823041e-02,5.8557393143525505e-01,5.5082621222042860e-01,5.8760961137766055e-01,

