1
1
15
0
(8 0
((0,0,0) (7,7,7) (0,0,0))
((8,0,0) (15,7,7) (0,0,0))
((0,8,0) (7,15,7) (0,0,0))
((8,8,0) (15,15,7) (0,0,0))
((0,0,8) (7,7,15) (0,0,0))
((8,0,8) (15,7,15) (0,0,0))
((0,8,8) (7,15,15) (0,0,0))
((8,8,8) (15,15,15) (0,0,0))
)
8
FabOnDisk: Cell_D_00000 0
FabOnDisk: Cell_D_00000 61527
FabOnDisk: Cell_D_00000 123055
FabOnDisk: Cell_D_00000 184583
FabOnDisk: Cell_D_00000 246112
FabOnDisk: Cell_D_00000 307640
FabOnDisk: Cell_D_00000 369169
FabOnDisk: Cell_D_00000 430698

8,15
1.02282023958032032e-02,2.78096337866979518e-03,-2.01378338764949850e-02,-1.49652321659932575e-02,-1.06684391084912230e-02,6.26358168521954806e-01,-1.91038836667900514e-03,-2.87326174871698793e-04,3.96371226800017445e-03,-1.16901333067718580e-02,-2.54260711215124960e-02,-4.92023373035700984e-02,-4.85915033231222870e-01,-5.03233709512115768e-01,-5.15683927147198240e-01,
1.00350632636294519e-02,1.29875199223029739e-03,-6.32901877656042670e-03,-1.54291077650509870e-02,-1.12722054576595999e-02,6.26629840082387313e-01,-3.21626819811493478e-02,-1.48429029002037378e-02,-1.09034167978743664e-02,-4.44997897111729102e-01,-3.02840923127453872e-02,-5.83621268069930976e-02,-3.80131451320448593e-02,-5.35296491809005737e-01,-5.60133115312645313e-01,
1.02918736977393455e-02,9.77607131944712880e-04,-2.27090099856663077e-02,1.60850355728308541e-03,-1.21430160819184733e-02,6.30165896813087989e-01,-2.03206030187781357e-03,-9.80126277356101368e-03,-2.15772918031190801e-02,-1.50300052753950530e-02,-4.53590135222661561e-01,-6.15944406818236603e-02,-5.13304004053821594e-01,-7.95340754506094483e-02,-5.73649920471897445e-01,
1.01016522180402326e-02,1.38892591372775345e-04,-5.80407496200399230e-03,3.44485874892842651e-03,-1.93041417752490146e-02,6.29219280728631425e-01,-3.81698316484656908e-01,-3.81074391502287779e-01,-4.31345955975189321e-01,-4.70698849061371938e-01,-4.59311772012987563e-01,-7.27592641800905715e-02,-4.32482916612869778e-02,-8.04770907181381612e-02,-6.03881249833857492e-01,
1.03173865632752333e-02,1.28417548594585910e-04,-2.23952440123247748e-02,-1.77549779584501230e-02,1.35862357766593743e-03,6.26919826467987606e-01,3.20479030980408809e-04,-2.65447642153623271e-02,-6.46921294898861361e-04,-1.66677658986368327e-02,-3.67434983476074978e-02,-4.34433246324253286e-01,-5.17256162134090536e-01,-5.59333952869298878e-01,-1.34476433948265639e-01,
1.01232559439693847e-02,-2.63770010990602610e-04,-5.25593122709172838e-03,-2.25151138589568950e-02,-6.45338904799034517e-05,6.27733260178757746e-01,-2.75838799721064634e-02,-6.91570166835525635e-01,-1.22480391710264487e-02,-4.80372208952689506e-01,-4.38149237851363643e-02,-4.67591222505754911e-01,-4.26979912254713961e-02,-5.61137067467975537e-01,-1.33910229432688266e-01,
1.04032443082184099e-02,-3.15516460305636170e-04,-1.90127062671970742e-02,-1.91276681882420960e-03,-1.11005875320096376e-03,6.25873800746094000e-01,-2.28782693323914474e-02,-2.16505501714805565e-02,-1.03121672026073759e-02,-2.16504530244426285e-02,-4.59798523656878788e-01,-4.77215736505933130e-01,-5.78500647925754952e-01,-8.16342746252799456e-02,-1.36359813969444382e-01,
1.01879326289395031e-02,-9.15128342441984266e-03,-8.62721532386651058e-03,-3.48488669013995427e-03,-1.84006357345292844e-03,6.23453322435640334e-01,-7.48127692042169445e-01,-7.54430597509502032e-01,-1.55688915013328048e-02,-4.82839576884548816e-01,-4.75946405345644696e-01,-5.03573788330159200e-01,-4.61809722981764703e-02,-8.76621427535717174e-02,-1.37132041612972683e-01,

8,15
1.19216657661761372e+00,1.06582411580515779e+00,1.92505506835326731e-02,2.14483601249700687e-02,2.74090142322599775e-02,1.19494753999628345e+00,2.47624507277884320e-02,1.45602710517438987e-02,2.05881233542756954e-02,4.40327092506262840e-01,4.61468703936022795e-01,4.75151990856707673e-01,1.35727543877537564e-03,2.99852759586667844e-03,5.90937559328611611e-03,
1.22970387209906096e+00,1.06464623272129466e+00,3.05254827272173103e-02,2.11276502033063140e-02,2.78863300741121999e-02,1.23100262409129124e+00,7.34869427742386450e-03,1.67544133164515829e-02,2.30344638994933668e-02,2.55745089704539422e-02,4.69026037592152556e-01,4.94892514664045324e-01,4.64961948411758641e-01,3.76394213386902713e-03,7.37521197032248600e-03,
1.24003315390073743e+00,1.06578077912479907e+00,1.88823390761247156e-02,3.69323354739619220e-02,2.96279108038041243e-02,1.24101076103268215e+00,5.65530876147884026e-02,1.36948390899195999e-02,4.82291187908824859e-02,4.39218118963213167e-01,5.17755902099299031e-02,4.99942295012148652e-01,1.87524578570628518e-03,5.00719755775388853e-01,7.81959885664531944e-03,
1.25857267926356298e+00,1.06472510207342674e+00,3.39522629982128357e-02,3.96982358249898526e-02,3.55457273299195561e-02,1.25871304612989654e+00,3.77829608899660496e-02,1.04914624723451949e-01,2.12005259368937038e+00,2.91335018801902774e-02,5.49920164882527346e-02,5.09066809938360176e-01,5.27052633940532589e-01,5.31343139375688445e-01,9.70084604920643662e-03,
1.25571710914323753e+00,1.06497298858461886e+00,1.87229712574285452e-02,2.10275474878699326e-02,4.53661644470878742e-02,1.25584552669183203e+00,1.19483045652906628e-01,6.70389102711210494e-02,3.95641849387435685e-01,4.60731930142088519e-01,4.69765224394607883e-01,8.88547946418179746e-02,2.07799983304612565e-03,4.58916803797407725e-03,5.09870666239313763e-01,
1.26629300815621759e+00,1.06389598997131851e+00,3.38018809500243572e-02,2.13232471869963559e-02,4.73175252320142820e-02,1.26602923814522694e+00,9.38867007617365523e-01,2.15270757499174958e-01,1.03666155143791516e+00,2.82280210296070311e-02,4.69723618622186312e-01,8.64728268957644375e-02,5.57722573019891255e-01,5.74038298640211150e-03,5.15524314759112867e-01,
1.26931235194129610e+00,1.06265777945192363e+00,1.82147254326055427e-02,3.85407508160244966e-02,4.81718085443150548e-02,1.26900948942587588e+00,1.11268013356444026e-01,6.34347892909688932e-02,6.79831139148881075e-02,4.98804342575989490e-01,5.47876505509925088e-02,9.00746077995302069e-02,2.86557432153025865e-03,5.51651321794861427e-01,5.34090432500335499e-01,
1.27579288587750406e+00,1.06159442692518002e+00,3.12548868950686953e-02,3.94680781225775004e-02,4.92805997237837981e-02,1.27557222994866337e+00,5.39759533190286245e-01,2.58665523045598644e-01,5.44003592737883679e-01,2.99801966562683042e-02,5.86994121014911066e-02,8.89326496489005330e-02,5.85862741804956455e-01,5.51965473205761281e-01,5.85579904818736230e-01,

