1
1
15
0
(8 0
((0,0,0) (7,7,7) (0,0,0))
((8,0,0) (15,7,7) (0,0,0))
((0,8,0) (7,15,7) (0,0,0))
((8,8,0) (15,15,7) (0,0,0))
((0,0,8) (7,7,15) (0,0,0))
((8,0,8) (15,7,15) (0,0,0))
((0,8,8) (7,15,15) (0,0,0))
((8,8,8) (15,15,15) (0,0,0))
)
8
FabOnDisk: Cell_D_00000 0
FabOnDisk: Cell_D_00000 61527
FabOnDisk: Cell_D_00000 123055
FabOnDisk: Cell_D_00000 184583
FabOnDisk: Cell_D_00000 246112
FabOnDisk: Cell_D_00000 307640
FabOnDisk: Cell_D_00000 369169
FabOnDisk: Cell_D_00000 430698

8,15
1.23688119254994049e-02,5.67515033722524737e-02,-1.51005826699164205e-02,-1.43854967864968930e-02,-1.12645414059404734e-02,6.34802663270377820e-01,-2.78759097602000912e-03,-1.44716245527059563e-03,-6.90830383889498448e-06,-9.82068286938073999e-03,-3.65768684458131280e-02,-1.30636535119643016e-01,-3.49389955988770373e-01,-3.91145721228832066e-01,-4.43806597182227702e-01,
1.21376118959836913e-02,2.42897182871316744e-02,-1.01671375049539187e-02,-1.46363214781516423e-02,-1.06800507030716356e-02,6.33019942652389700e-01,-8.19824569474278397e-03,-1.75840075329750816e-03,-8.51009679272809235e-04,-3.60080456431169371e-01,-4.85158269416198357e-02,-1.67013991740198486e-01,-8.93540453385356093e-02,-4.48734649190257184e-01,-5.02194941280121321e-01,
1.21415257310232335e-02,8.40245261723578281e-03,-1.34714659275364090e-02,-9.82391221429457749e-03,-9.69987001030086018e-03,6.29178677387477014e-01,-2.29744049699120078e-03,-9.59562647428325970e-03,-2.50007799868476599e-02,-1.72691254620738754e-02,-3.99395605043287083e-01,-2.09966559492503674e-01,-4.26501253309226336e-01,-1.75308167409248261e-01,-5.64683539859398120e-01,
1.21725470439649399e-02,2.78305657036461655e-03,-1.57250540237178563e-02,-1.41052643821847398e-02,-1.28352751327964060e-02,6.27913028438388698e-01,-1.45489075984508876e-02,-1.15148593390126883e-02,-4.66721647241762072e-02,-4.29665589373319501e-01,-4.08976115128064421e-01,-2.61185093084698561e-01,-8.97053181642204489e-02,-1.78088745407119414e-01,-6.02729980375888319e-01,
1.21843444853117124e-02,1.91963999180440521e-03,-1.32851232536819984e-02,-1.44182995837294995e-02,-1.13302339927511021e-02,6.28725422834694347e-01,-2.95699277886114992e-03,-2.44842948979291097e-02,-5.83526063379449962e-03,-2.44043435978601626e-02,-8.96453719318298231e-02,-4.39142919056872361e-01,-5.17438768016798001e-01,-5.24502168374922695e-01,-2.83283714652373897e-01,
1.22133855194976743e-02,2.95440004433696144e-04,-1.43095924224531813e-02,-1.34902465566896189e-02,-1.08762966287061138e-02,6.29590914682402580e-01,-9.87293250967245239e-02,-1.93492501709529113e-01,-2.27718885585978456e-02,-4.60589537177193531e-01,-1.16655182068371402e-01,-4.50608636952311570e-01,-9.04602593093915691e-02,-5.99659964211051166e-01,-2.87026349796821456e-01,
1.23069438477149667e-02,-4.27068165894579172e-04,-1.45041236261817773e-02,-1.09509913239308337e-02,-9.23712236295176972e-03,6.28091814923219416e-01,-1.30903499786196331e+00,-3.95688246822988421e-01,-8.53204357534749214e-01,-4.18533357729245076e-02,-4.84967202759798321e-01,-4.49585708863144640e-01,-5.79473690543455544e-01,-1.82200611936419565e-01,-2.86070201108160060e-01,
1.23983708407875599e-02,-8.14796598612598411e-04,-1.67756230942108023e-02,-1.11941159345575747e-02,-1.38528179076379005e-02,6.28528158571518780e-01,-2.83385689736202151e-01,-2.15615058446676361e-02,-4.74959713140831130e-01,-4.75868723236891999e-01,-5.06886888257402246e-01,-4.95488920316242532e-01,-9.20553970571369451e-02,-1.84635733339250430e-01,-2.86897242782483297e-01,

8,15
7.85609517024369652e-01,1.05510247086624642e+00,1.34556723239431832e-02,1.58617122946773277e-02,1.74121377618996417e-02,1.06747128279174586e+00,1.00623625507619933e-02,1.21854710539453168e-02,9.70137303607120777e-03,3.68478154021881832e-01,4.04378392475702286e-01,4.24925566736161220e-01,1.08977097754197260e-03,4.18620138563841233e-03,1.99591072994430539e-02,
9.44420229157645563e-01,1.05610025116034167e+00,1.86403267899477691e-02,1.96233877249608960e-02,2.09895224427223137e-02,1.06824018406140975e+00,5.29717314248082539e-03,1.57231128924840563e-02,1.01464734409809250e-02,5.73813727293910891e-02,4.24908275976466854e-01,4.63230221892558136e-01,3.45279376254298165e-01,5.87757578888495509e-03,2.86102695845294221e-02,
1.08273884759170991e+00,1.05608099758142426e+00,1.87231541952983180e-02,2.06346213714871454e-02,1.87291485296532563e-02,1.09114130020894562e+00,1.79197420672702022e-02,1.05565089628227790e-02,1.36929401735722354e-02,4.25420925359789814e-01,1.14120458184036710e-01,4.87852917185175372e-01,2.04364161234589546e-03,3.96268736570068447e-01,4.03615990943419004e-02,
1.18633624976968388e+00,1.05567880842027839e+00,1.71738692812691135e-02,2.10350378392693133e-02,2.18909869403765001e-02,1.18911930634004848e+00,2.03509288068657798e-02,1.14949843269307392e-02,1.38993264881131940e-02,5.83922171393863043e-02,1.15266480616741163e-01,4.94982003897370681e-01,4.36705111262495671e-01,4.44675007615002671e-01,5.73343750865399904e-02,
1.21414609652444105e+00,1.05575184184453685e+00,1.78866604919619143e-02,1.61333807800530214e-02,2.18150918815751341e-02,1.21606573651624550e+00,2.05589590765267831e-02,1.39367227198398808e-02,1.33323054424302635e-02,4.64778646427752573e-01,4.71070756165488325e-01,1.81162880475833760e-01,2.96964152411571466e-03,1.20056517923571807e-02,4.66927099211920993e-01,
1.26244438118305280e+00,1.05533849680027991e+00,1.69123858581700197e-02,1.68653051234825616e-02,2.10779474110174489e-02,1.26273982118748651e+00,1.21138522619557043e-01,1.33751362961557728e-02,5.76932109749033889e-02,5.84593080581808783e-02,5.07644698321419896e-01,1.80961312574289962e-01,5.20177109967678408e-01,1.69356144401045274e-02,5.16926888682501473e-01,
1.28317261773806512e+00,1.05448896633006650e+00,1.91996451165982671e-02,2.11634015736129680e-02,2.15579959512420330e-02,1.28274554957217046e+00,5.91050856686334558e-02,3.67842118322967149e-02,2.09202191854879072e+00,4.75745388590340545e-01,1.16540316112062919e-01,1.81969915542882721e-01,5.65720637822701451e-03,5.51414351011751069e-01,5.40140104867019355e-01,
1.29136935394237606e+00,1.05296681011640070e+00,1.81545011625405400e-02,2.02826277793715717e-02,2.18866738886361878e-02,1.29062450582787447e+00,9.28720488895342089e-02,4.92003768175289125e-01,2.69472241327459616e-01,5.90761363265426415e-02,1.17557900530119455e-01,1.83022153124588721e-01,5.62426732001681140e-01,6.09220468585642383e-01,5.77022563816877887e-01,

