1
1
15
0
(8 0
((0,0,0) (7,7,7) (0,0,0))
((8,0,0) (15,7,7) (0,0,0))
((0,8,0) (7,15,7) (0,0,0))
((8,8,0) (15,15,7) (0,0,0))
((0,0,8) (7,7,15) (0,0,0))
((8,0,8) (15,7,15) (0,0,0))
((0,8,8) (7,15,15) (0,0,0))
((8,8,8) (15,15,15) (0,0,0))
)
8
FabOnDisk: Cell_D_00000 0
FabOnDisk: Cell_D_00000 61527
FabOnDisk: Cell_D_00000 123055
FabOnDisk: Cell_D_00000 184583
FabOnDisk: Cell_D_00000 246112
FabOnDisk: Cell_D_00000 307640
FabOnDisk: Cell_D_00000 369169
FabOnDisk: Cell_D_00000 430698

8,15
1.23664048501028051e-02,6.13227507129611507e-02,-1.51693162655614881e-02,-1.42119828210182982e-02,-1.12774979934774280e-02,6.32936231239730085e-01,-2.82798540085592428e-03,-1.54193228239006834e-03,1.10001266394422017e-04,-9.53824030117552193e-03,-3.70742696477287664e-02,-1.34288779483661802e-01,-3.44293791796329629e-01,-3.85856852401465944e-01,-4.46078769957183985e-01,
1.21367941363274851e-02,2.68893556983398375e-02,-1.00999696119840852e-02,-1.44869626023895314e-02,-1.07235977602911370e-02,6.35058718269038702e-01,-7.81426261808702838e-03,-1.67212707865270005e-03,-6.18286225986370902e-04,-3.59345347303646423e-01,-4.91204259497768705e-02,-1.71550512187007620e-01,-8.93568300220358852e-02,-4.44727212376014480e-01,-4.96489278956200875e-01,
1.21414847236188828e-02,9.09328702059147495e-03,-1.33529113883897634e-02,-9.73344672202195241e-03,-9.78690359336874087e-03,6.29338891979856596e-01,-2.37278055598310949e-03,-9.66163980332113669e-03,-2.25338471656560228e-02,-1.69127373547049049e-02,-3.97462641518582904e-01,-2.16771661395262327e-01,-4.21339695283625526e-01,-1.79261632437121371e-01,-5.63730150576279954e-01,
1.21720786024359113e-02,3.00147577929818629e-03,-1.58615959419449240e-02,-1.43924463345511539e-02,-1.26624533443275913e-02,6.27905542786532544e-01,-1.58724101168529336e-02,-1.23140549688584358e-02,-4.67391130863132470e-02,-4.27187897504860470e-01,-4.07073053349136738e-01,-2.69128189299710774e-01,-8.89630849503152688e-02,-1.80258421335842522e-01,-6.04950003242922252e-01,
1.21802957980219149e-02,1.98103780500100786e-03,-1.32788826349002614e-02,-1.43550421802556109e-02,-1.15737483141580312e-02,6.28722866313148776e-01,-2.91351764843360934e-03,-2.62464329689937673e-02,-5.41497800091936266e-03,-2.42131497334653126e-02,-9.25843712644775219e-02,-4.37619012708348021e-01,-5.15727280297953117e-01,-5.21831671537038466e-01,-2.87016009046835441e-01,
1.22091878561258662e-02,3.33568189270617966e-04,-1.42576226885572557e-02,-1.33570030281063793e-02,-1.08448379106305046e-02,6.29723533069666663e-01,-9.26002716104676604e-02,-1.64652305730597637e-01,-1.76984900556634156e-02,-4.60227216186325283e-01,-1.20330622419879324e-01,-4.47736405180336750e-01,-9.02414645695911177e-02,-5.98251889457932395e-01,-2.91582517220441595e-01,
1.23065991889879951e-02,-4.39411657845564438e-04,-1.46070191695957634e-02,-1.09226327756999381e-02,-9.56176740078401241e-03,6.28932144993945785e-01,-1.86717144025215802e+01,-2.01403453360099682e+00,-2.41039477887985965e-01,-4.18857509312563075e-02,-4.85802162387347525e-01,-4.51642305837707092e-01,-5.79377754203840967e-01,-1.85216930789941669e-01,-2.90609486468762501e-01,
1.24004318073000063e-02,-8.22634205257448555e-04,-1.68189524499656601e-02,-1.12926258661791151e-02,-1.38817632371353635e-02,6.28797728450758653e-01,-1.19003635116744708e-01,-2.24944863961500166e-02,-6.83659202506800767e+00,-4.76061953060164467e-01,-5.06085746861668073e-01,-4.98525386141352111e-01,-9.23583976770663562e-02,-1.87769102018773643e-01,-2.91775666896113617e-01,

8,15
7.68704145225136082e-01,1.05510427289638886e+00,1.34143889141299481e-02,1.61220393044604546e-02,1.72656971722385116e-02,1.06747067774649174e+00,9.65651428012770895e-03,1.18780524140734214e-02,9.77892023664150845e-03,3.67149567850947434e-01,4.02412831076996380e-01,4.20695890069787914e-01,1.05846159310383743e-03,4.24887351155923531e-03,2.08465453090202549e-02,
9.27969287372495955e-01,1.05610401984690605e+00,1.87461757547117136e-02,1.97852605000085474e-02,2.09985257039806486e-02,1.06824139044895894e+00,5.15801352689042834e-03,1.60098863879057744e-02,1.01994878883255244e-02,5.70703964184811410e-02,4.24902843433889565e-01,4.60680423489717994e-01,3.40565532952209538e-01,5.95903552012011159e-03,2.99171019056375422e-02,
1.07382287866508341e+00,1.05608928506052790e+00,1.88166820762940348e-02,2.03432073605347118e-02,1.87686792963370173e-02,1.08291616568567495e+00,1.90334197624469174e-02,1.11228911856226468e-02,1.35750331234075847e-02,4.22769927960580105e-01,1.16384945790176747e-01,4.88511213430635305e-01,1.99871444187093780e-03,3.92696447952965211e-01,4.26695710829322686e-02,
1.18000335501793141e+00,1.05569539290064585e+00,1.70012190451704140e-02,2.07475346457258771e-02,2.19323757010228167e-02,1.18300483079722962e+00,2.00181622885836005e-02,1.22259383521297893e-02,1.39243957100916999e-02,5.82349103319126510e-02,1.16824309636375370e-01,4.97954123382711888e-01,4.31435859170011704e-01,4.40993864162153026e-01,6.06562088805395749e-02,
1.21214077512482055e+00,1.05576741399198881e+00,1.78973467986356730e-02,1.61550667113000840e-02,2.20243115176065214e-02,1.21412181292982146e+00,2.02933081027736675e-02,1.38542868338572597e-02,1.25076382630450993e-02,4.64187263450353549e-01,4.69344593628214124e-01,1.84256875559650229e-01,2.94483215448928040e-03,1.24820991344714340e-02,4.65674737996151888e-01,
1.26145831856969615e+00,1.05535792519538862e+00,1.68765018241633924e-02,1.67860143343196606e-02,2.13104736820996267e-02,1.26179188675896681e+00,1.13375632508190910e-01,1.32639860070338303e-02,5.22818815982838622e-02,5.86141854335588200e-02,5.07073651039650408e-01,1.84280114412703422e-01,5.18653809534067700e-01,1.76100031305835188e-02,5.14326875281817530e-01,
1.28299902563085966e+00,1.05446846100571312e+00,1.92647751982831239e-02,2.09136442740092895e-02,2.17765315459868651e-02,1.28255961397301399e+00,6.14841970453791492e-02,4.44530968220304551e-02,2.68499416673882294e+01,4.75859313969249520e-01,1.18530294096089062e-01,1.84631147225335163e-01,5.66499750666381394e-03,5.53669155077494923e-01,5.35981530377645510e-01,
1.29130886880278895e+00,1.05292123725920383e+00,1.82785143572161760e-02,1.99689227040872816e-02,2.20603756101923065e-02,1.29055379689651217e+00,3.97331939298986603e+00,6.02071366003103514e-01,2.80439816273024389e-01,5.90741730349644278e-02,1.19555900916803695e-01,1.86108261366940975e-01,5.62408939527797802e-01,6.09399348645177863e-01,5.81888739146239065e-01,

