1
1
15
0
(8 0
((0,0,0) (7,7,7) (0,0,0))
((8,0,0) (15,7,7) (0,0,0))
((0,8,0) (7,15,7) (0,0,0))
((8,8,0) (15,15,7) (0,0,0))
((0,0,8) (7,7,15) (0,0,0))
((8,0,8) (15,7,15) (0,0,0))
((0,8,8) (7,15,15) (0,0,0))
((8,8,8) (15,15,15) (0,0,0))
)
8
FabOnDisk: Cell_D_00000 0
FabOnDisk: Cell_D_00000 61527
FabOnDisk: Cell_D_00000 123055
FabOnDisk: Cell_D_00000 184583
FabOnDisk: Cell_D_00000 246112
FabOnDisk: Cell_D_00000 307640
FabOnDisk: Cell_D_00000 369169
FabOnDisk: Cell_D_00000 430698

8,15
1.2366404850102805e-02,6.1322750712961151e-02,-1.5169316265561488e-02,-1.4211982821018298e-02,-1.1277497993477428e-02,6.3293623123973008e-01,-2.8279854008559243e-03,-1.5419322823900683e-03,1.1000126639442202e-04,-9.5382403011755219e-03,-3.7074269647728766e-02,-1.3428877948366180e-01,-3.4429379179632963e-01,-3.8585685240146594e-01,-4.4607876995718398e-01,
1.2136794136327485e-02,2.6889355698339838e-02,-1.0099969611984085e-02,-1.4486962602389531e-02,-1.0723597760291137e-02,6.3505871826903870e-01,-7.8142626180870284e-03,-1.6721270786527001e-03,-6.1828622598637090e-04,-3.5934534730364642e-01,-4.9120425949776871e-02,-1.7155051218700762e-01,-8.9356830022035885e-02,-4.4472721237601448e-01,-4.9648927895620087e-01,
1.2141484723618883e-02,9.0932870205914750e-03,-1.3352911388389763e-02,-9.7334467220219524e-03,-9.7869035933687409e-03,6.2933889197985660e-01,-2.3727805559831095e-03,-9.6616398033211367e-03,-2.2533847165656023e-02,-1.6912737354704905e-02,-3.9746264151858290e-01,-2.1677166139526233e-01,-4.2133969528362553e-01,-1.7926163243712137e-01,-5.6373015057627995e-01,
1.2172078602435911e-02,3.0014757792981863e-03,-1.5861595941944924e-02,-1.4392446334551154e-02,-1.2662453344327591e-02,6.2790554278653254e-01,-1.5872410116852934e-02,-1.2314054968858436e-02,-4.6739113086313247e-02,-4.2718789750486047e-01,-4.0707305334913674e-01,-2.6912818929971077e-01,-8.8963084950315269e-02,-1.8025842133584252e-01,-6.0495000324292225e-01,
1.2180295798021915e-02,1.9810378050010079e-03,-1.3278882634900261e-02,-1.4355042180255611e-02,-1.1573748314158031e-02,6.2872286631314878e-01,-2.9135176484336093e-03,-2.6246432968993767e-02,-5.4149780009193627e-03,-2.4213149733465313e-02,-9.2584371264477522e-02,-4.3761901270834802e-01,-5.1572728029795312e-01,-5.2183167153703847e-01,-2.8701600904683544e-01,
1.2209187856125866e-02,3.3356818927061797e-04,-1.4257622688557256e-02,-1.3357003028106379e-02,-1.0844837910630505e-02,6.2972353306966666e-01,-9.2600271610467660e-02,-1.6465230573059764e-01,-1.7698490055663416e-02,-4.6022721618632528e-01,-1.2033062241987932e-01,-4.4773640518033675e-01,-9.0241464569591118e-02,-5.9825188945793240e-01,-2.9158251722044159e-01,
1.2306599188987995e-02,-4.3941165784556444e-04,-1.4607019169595763e-02,-1.0922632775699938e-02,-9.5617674007840124e-03,6.2893214499394579e-01,-1.8671714402521580e+01,-2.0140345336009968e+00,-2.4103947788798596e-01,-4.1885750931256308e-02,-4.8580216238734752e-01,-4.5164230583770709e-01,-5.7937775420384097e-01,-1.8521693078994167e-01,-2.9060948646876250e-01,
1.2400431807300006e-02,-8.2263420525744855e-04,-1.6818952449965660e-02,-1.1292625866179115e-02,-1.3881763237135364e-02,6.2879772845075865e-01,-1.1900363511674471e-01,-2.2494486396150017e-02,-6.8365920250680077e+00,-4.7606195306016447e-01,-5.0608574686166807e-01,-4.9852538614135211e-01,-9.2358397677066356e-02,-1.8776910201877364e-01,-2.9177566689611362e-01,

8,15
7.6870414522513608e-01,1.0551042728963889e+00,1.3414388914129948e-02,1.6122039304460455e-02,1.7265697172238512e-02,1.0674706777464917e+00,9.6565142801277089e-03,1.1878052414073421e-02,9.7789202366415084e-03,3.6714956785094743e-01,4.0241283107699638e-01,4.2069589006978791e-01,1.0584615931038374e-03,4.2488735115592353e-03,2.0846545309020255e-02,
9.2796928737249595e-01,1.0561040198469061e+00,1.8746175754711714e-02,1.9785260500008547e-02,2.0998525703980649e-02,1.0682413904489589e+00,5.1580135268904283e-03,1.6009886387905774e-02,1.0199487888325524e-02,5.7070396418481141e-02,4.2490284343388957e-01,4.6068042348971799e-01,3.4056553295220954e-01,5.9590355201201116e-03,2.9917101905637542e-02,
1.0738228786650834e+00,1.0560892850605279e+00,1.8816682076294035e-02,2.0343207360534712e-02,1.8768679296337017e-02,1.0829161656856749e+00,1.9033419762446917e-02,1.1122891185622647e-02,1.3575033123407585e-02,4.2276992796058011e-01,1.1638494579017675e-01,4.8851121343063530e-01,1.9987144418709378e-03,3.9269644795296521e-01,4.2669571082932269e-02,
1.1800033550179314e+00,1.0556953929006458e+00,1.7001219045170414e-02,2.0747534645725877e-02,2.1932375701022817e-02,1.1830048307972296e+00,2.0018162288583601e-02,1.2225938352129789e-02,1.3924395710091700e-02,5.8234910331912651e-02,1.1682430963637537e-01,4.9795412338271189e-01,4.3143585917001170e-01,4.4099386416215303e-01,6.0656208880539575e-02,
1.2121407751248205e+00,1.0557674139919888e+00,1.7897346798635673e-02,1.6155066711300084e-02,2.2024311517606521e-02,1.2141218129298215e+00,2.0293308102773668e-02,1.3854286833857260e-02,1.2507638263045099e-02,4.6418726345035355e-01,4.6934459362821412e-01,1.8425687555965023e-01,2.9448321544892804e-03,1.2482099134471434e-02,4.6567473799615189e-01,
1.2614583185696961e+00,1.0553579251953886e+00,1.6876501824163392e-02,1.6786014334319661e-02,2.1310473682099627e-02,1.2617918867589668e+00,1.1337563250819091e-01,1.3263986007033830e-02,5.2281881598283862e-02,5.8614185433558820e-02,5.0707365103965041e-01,1.8428011441270342e-01,5.1865380953406770e-01,1.7610003130583519e-02,5.1432687528181753e-01,
1.2829990256308597e+00,1.0544684610057131e+00,1.9264775198283124e-02,2.0913644274009290e-02,2.1776531545986865e-02,1.2825596139730140e+00,6.1484197045379149e-02,4.4453096822030455e-02,2.6849941667388229e+01,4.7585931396924952e-01,1.1853029409608906e-01,1.8463114722533516e-01,5.6649975066638139e-03,5.5366915507749492e-01,5.3598153037764551e-01,
1.2913088688027889e+00,1.0529212372592038e+00,1.8278514357216176e-02,1.9968922704087282e-02,2.2060375610192307e-02,1.2905537968965122e+00,3.9733193929898660e+00,6.0207136600310351e-01,2.8043981627302439e-01,5.9074173034964428e-02,1.1955590091680370e-01,1.8610826136694097e-01,5.6240893952779780e-01,6.0939934864517786e-01,5.8188873914623906e-01,

