1
1
15
0
(8 0
((0,0,0) (7,7,7) (0,0,0))
((8,0,0) (15,7,7) (0,0,0))
((0,8,0) (7,15,7) (0,0,0))
((8,8,0) (15,15,7) (0,0,0))
((0,0,8) (7,7,15) (0,0,0))
((8,0,8) (15,7,15) (0,0,0))
((0,8,8) (7,15,15) (0,0,0))
((8,8,8) (15,15,15) (0,0,0))
)
8
FabOnDisk: Cell_D_00000 0
FabOnDisk: Cell_D_00000 61527
FabOnDisk: Cell_D_00000 123055
FabOnDisk: Cell_D_00000 184583
FabOnDisk: Cell_D_00000 246112
FabOnDisk: Cell_D_00000 307640
FabOnDisk: Cell_D_00000 369169
FabOnDisk: Cell_D_00000 430698

8,15
1.23245253562203512e-02,3.10971221842171498e-02,-1.35764824711702946e-02,-1.51454625908823016e-02,-9.49682751254821156e-03,6.27599205753899714e-01,-2.02524194670112428e-03,-6.45432538058859982e-04,-1.74510261426011760e-04,-9.82741986176932647e-03,-3.64920570494189495e-02,-1.05885980140900143e-01,-3.73645565836150439e-01,-4.26675935214021085e-01,-4.69312824665350903e-01,
1.21107989275316564e-02,1.28243496831964704e-02,-1.02095826584474407e-02,-1.49485868554776104e-02,-9.46165440765998032e-03,6.27867418264513422e-01,-9.73498311712225547e-03,-5.44875592661664648e-04,-3.15079769867501617e-03,-3.69236894258645809e-01,-4.68484319808532002e-02,-1.32785067526016209e-01,-7.51383242992111899e-02,-4.68217186155634346e-01,-5.24962039833045346e-01,
1.21235491671146788e-02,4.42266565303575752e-03,-1.37555014534900440e-02,-8.88108337667108810e-03,-8.93403242852244123e-03,6.28342020004242885e-01,-1.79977601261025561e-03,-8.83560745881218496e-03,-4.08019770822541233e-02,-1.65662684611848805e-02,-4.12309575720667620e-01,-1.67788813836287687e-01,-4.66558861888632326e-01,-1.66139769429560435e-01,-5.65617804257111056e-01,
1.21485830634970298e-02,1.71825907679078660e-03,-1.32701664435117481e-02,-1.14693365063112951e-02,-1.17188346278555827e-02,6.28049517659460377e-01,-2.13104347411676998e-02,-8.59286825203543943e-03,-4.36075754842484009e-02,-4.42342347572549421e-01,-4.18110920915468087e-01,-2.06549668318127294e-01,-7.94364202703503747e-02,-1.67073539027617346e-01,-5.77335627794761441e-01,
1.21794508678104308e-02,1.58350665282950133e-03,-1.31885409560471862e-02,-1.41520384847855889e-02,-8.06374801521551540e-03,6.28501033024696176e-01,-2.66848372425287396e-03,-2.57795982021505853e-02,-7.53431381481852423e-03,-2.12742791890193073e-02,-7.82871105874993201e-02,-4.46444469650415177e-01,-5.24179567235375843e-01,-5.39769388670777506e-01,-2.52517137686764981e-01,
1.22084643911287878e-02,2.24458823894866473e-04,-1.40196918366424939e-02,-1.35387561540699329e-02,-9.70428028762254993e-03,6.28065566464301783e-01,-7.57790242876502929e-02,-2.47579525732119887e-01,-2.60961421811386901e-02,-4.64666993425704000e-01,-9.91513251985312871e-02,-4.66155098772244980e-01,-7.88071175926063627e-02,-6.01099801621411634e-01,-2.53398304979547795e-01,
1.22901887035208428e-02,-4.10445379666765642e-04,-1.25801041690970488e-02,-9.69741206234290068e-03,-8.92427892646979748e-03,6.28913583490086858e-01,-2.92261525868940455e-02,-1.78359524995423402e-02,-1.49628205280789919e-02,-3.50781519826999372e-02,-4.81769947986152858e-01,-4.71240588216588041e-01,-5.67601683268048829e-01,-1.69429634884981362e-01,-2.53812282612781159e-01,
1.23597645063803184e-02,-7.27862214144275248e-04,-1.51254239746051056e-02,-1.28205219515918605e-02,-1.13153734946622661e-02,6.28210117274108248e-01,-2.77680037342005082e-01,-1.85986311790099640e-02,-2.85929061083278757e-02,-4.71203731264831671e-01,-5.07438891190325481e-01,-4.70895106267825936e-01,-8.14957898919356910e-02,-1.70345891345859257e-01,-2.55198850581991432e-01,

8,15
9.01526884639983317e-01,1.05528480627673660e+00,1.45541856494700497e-02,1.66540411212815244e-02,1.95793529415858245e-02,1.06761604079351002e+00,1.21790896293629963e-02,1.19543422300971910e-02,9.21099973016781259e-03,3.73870840786178604e-01,4.14514995253850327e-01,4.46816442518163159e-01,1.09153322074795529e-03,4.17741126304028640e-03,1.46012978648711045e-02,
1.03393990668255209e+00,1.05621417094950742e+00,1.76665562967602760e-02,1.83009121468656125e-02,2.19222609275076634e-02,1.06833700265323861e+00,6.30755230253985874e-03,1.24726271378524690e-02,1.17380174879340889e-02,5.02537297561270815e-02,4.21169261293406483e-01,4.68451471611198600e-01,3.74571743094887055e-01,5.65786036786761724e-03,2.00353077479138372e-02,
1.14743713599985453e+00,1.05612827134197040e+00,1.71197825055822289e-02,2.24175853891716084e-02,2.04333920859132989e-02,1.15185980165289026e+00,1.55638802721829519e-02,8.29095726047632264e-03,1.37462656832725953e-02,4.43918822537010316e-01,1.06318454733022399e-01,4.75677037679809234e-01,1.97760543299620693e-03,4.25860044144268368e-01,2.78492945965017474e-02,
1.22057591092171824e+00,1.05578771899260437e+00,1.80859112677712319e-02,2.25832928196965446e-02,2.29124203502677551e-02,1.22229416999850904e+00,2.80797263321407864e-02,9.22380594186137000e-03,1.54363467680736638e-02,5.12660162393625343e-02,1.06441902455560539e-01,4.75611088054317177e-01,4.63423660600140064e-01,4.66608917793013722e-01,3.79698440431029266e-02,
1.22615150164897901e+00,1.05575919410259078e+00,1.80706255605616387e-02,1.70133571615432994e-02,2.22894231021375060e-02,1.22773500830180859e+00,2.39467966462361473e-02,1.45267686944638204e-02,1.97858129464530130e-02,4.63975106380320135e-01,4.79873322399020197e-01,1.61215760501185523e-01,2.58565205681357893e-03,1.02268723948163165e-02,4.72097898101514757e-01,
1.26488110361832296e+00,1.05541211746129804e+00,1.76461678903752292e-02,1.97229160382701267e-02,2.22635436975334444e-02,1.26510556244221783e+00,1.41710114138787258e-01,1.58551093985235883e-02,1.07863928467696185e-01,5.12417117662655325e-02,5.07526793939336973e-01,1.61420641308355761e-01,5.23912066609911520e-01,1.38437875910901818e-02,5.25934510223490470e-01,
1.28274225197504865e+00,1.05457448773093443e+00,1.89191233259943664e-02,2.25125057699229469e-02,2.26560777801526197e-02,1.28236107180877967e+00,5.67732476282390847e-02,4.70697215629501398e-02,1.31070577710650615e-01,4.68606127817606632e-01,1.08002475397435516e-01,1.62446762961159369e-01,4.71884596446951483e-03,5.44274934283500267e-01,5.64313224942549763e-01,
1.29065924041977609e+00,1.05339628181556111e+00,1.69651461043873741e-02,2.20236040240918557e-02,2.23641532542813784e-02,1.28997360515170745e+00,2.56372162522217395e-01,1.66785489305758983e+00,3.46210209116328993e-01,5.25096817757608539e-02,1.08902604729578245e-01,1.63103982269865999e-01,5.72197997180218243e-01,6.03172999090847761e-01,5.71442382735609322e-01,

