1
1
15
0
(8 0
((0,0,0) (7,7,7) (0,0,0))
((8,0,0) (15,7,7) (0,0,0))
((0,8,0) (7,15,7) (0,0,0))
((8,8,0) (15,15,7) (0,0,0))
((0,0,8) (7,7,15) (0,0,0))
((8,0,8) (15,7,15) (0,0,0))
((0,8,8) (7,15,15) (0,0,0))
((8,8,8) (15,15,15) (0,0,0))
)
8
FabOnDisk: Cell_D_00000 0
FabOnDisk: Cell_D_00000 61527
FabOnDisk: Cell_D_00000 123055
FabOnDisk: Cell_D_00000 184583
FabOnDisk: Cell_D_00000 246112
FabOnDisk: Cell_D_00000 307640
FabOnDisk: Cell_D_00000 369169
FabOnDisk: Cell_D_00000 430698

8,15
1.1400515898026008e-02,4.2388112668955667e-03,-1.4497013326245185e-02,-9.3768418006236667e-03,-7.1410319559452005e-03,6.2684441680416403e-01,-2.1110564254120381e-03,-9.8443836517458222e-03,-1.9358780602380658e-02,-1.0665744561248913e-02,-2.6005916118808609e-02,-5.8110853025177413e-02,-4.6722557760614247e-01,-4.7587903059124770e-01,-4.9390410388646322e-01,
1.1210756604473279e-02,1.9239474416901669e-03,-7.7574159449737426e-03,-9.8250794384086258e-03,-5.6481736939444447e-03,6.2894356320172307e-01,-2.1921249934148589e-02,-4.2969721751918589e-03,-1.0819933576324298e-02,-4.2935888265302835e-01,-3.1772678619944775e-02,-7.0241533521767721e-02,-4.7135821035422520e-02,-5.2281564642849110e-01,-5.3207745915800364e-01,
1.1389421311447970e-02,1.3157844051370415e-03,-1.4660728868271918e-02,-1.6866488241238809e-03,-4.2971984473992239e-03,6.2831983585783746e-01,-1.7360072393008583e-03,-7.3710255428331263e-03,-1.0574150551991304e-02,-1.4639549282631281e-02,-4.4727420527460215e-01,-7.8953973436785257e-02,-5.1771115746802865e-01,-9.7836502771286596e-02,-5.5991085989537570e-01,
1.1266714807492976e-02,2.2342162375062544e-04,-1.0531141270854385e-02,-3.9069518766956350e-03,-8.7270609193459657e-03,6.2768764755647322e-01,-5.3710259911001819e-02,-5.1448239349233940e-02,-2.9916728242246782e-01,-4.6612377773989172e-01,-4.5455244004827150e-01,-9.5029723908412994e-02,-5.0136273739780482e-02,-1.0102505944566414e-01,-6.0682094871199876e-01,
1.1482477989563306e-02,3.3782591466226101e-04,-1.5061839466617414e-02,-8.3576541171304208e-03,-2.7936417551310821e-04,6.2844673714797894e-01,-1.1608257504772436e-02,-3.6202983222777360e-02,1.7464808714423834e-04,-1.7183142360699954e-02,-4.2410125101108254e-02,-4.4162412274844903e-01,-5.3272044233607385e-01,-5.7353120446079064e-01,-1.6494217158068838e-01,
1.1320322331545778e-02,-2.7881005705446255e-04,-7.9994728754078093e-03,-1.4839031924633230e-02,-1.0960097560407992e-06,6.3029336285794257e-01,-5.1878010843804834e-01,-1.5322140689394925e+00,3.8478094671009469e-04,-4.7924440496090132e-01,-5.1506679099054944e-02,-4.7350273099682882e-01,-4.9740717121436628e-02,-5.8585231275313143e-01,-1.6341170382460352e-01,
1.1557600328790935e-02,-3.3261277493893857e-04,-1.2732784295897174e-02,-5.1885720165059952e-03,-9.3904407394466624e-04,6.2546884154300630e-01,-2.9007445963408804e-02,-9.7561273486501364e-03,-1.5208397262244426e-02,-2.3483770047816356e-02,-4.5238635745855971e-01,-4.9062834069729783e-01,-5.7771875710189957e-01,-1.0473329768795875e-01,-1.6930959928853989e-01,
1.1390995985888670e-02,-7.6543727026654308e-04,-1.3664709771835107e-02,-1.0891987476579506e-02,-3.4356162267507148e-03,6.2464812658018043e-01,-9.3966416555518240e-02,-3.9361616180714605e-02,-2.0210234392427938e-02,-4.8356435153187732e-01,-4.8809941454886807e-01,-5.1144528584034632e-01,-5.4612177859847247e-02,-1.0739622957897706e-01,-1.7069938000177454e-01,

8,15
1.1562028238681921e+00,1.0580266595674290e+00,1.7699358566719361e-02,2.2259710162894852e-02,2.8234969300318238e-02,1.1604416351350877e+00,1.4330654364442807e-02,1.6005881374575454e-02,1.9990743252830828e-02,4.3945506212794144e-01,4.5187230300883191e-01,4.4928444820924596e-01,1.2254726691582757e-03,3.0257707722137713e-03,6.9876355081384331e-03,
1.2139063093609817e+00,1.0586461149652928e+00,2.2113356004068802e-02,2.2166869026625978e-02,2.8235469411550029e-02,1.2158302568026718e+00,2.1433202587602750e-02,2.0959615473523235e-02,2.0231806075372231e-02,3.0101984389823915e-02,4.7123730959965698e-01,4.8065814713261373e-01,4.3686952261946149e-01,3.8775303137212891e-03,8.8954047014747680e-03,
1.2361093810173096e+00,1.0587500834291128e+00,1.8653070203093085e-02,2.7912121331791329e-02,2.8166185723749241e-02,1.2374251654224466e+00,4.8974851215199629e-02,2.0091380086368574e-02,2.0486353462020348e-02,4.4820117214090743e-01,6.4967558193108205e-02,4.9337545144937955e-01,1.7954329843499700e-03,4.8772986427562259e-01,1.0195332651656629e-02,
1.2630804573681236e+00,1.0582688711261878e+00,2.4207097678809238e-02,2.8129089045001540e-02,2.8063788377541119e-02,1.2633038789918742e+00,1.4621337579097599e-01,1.0932432973129280e-01,2.5403072793423805e-02,3.3869473941047362e-02,6.6403654859967243e-02,5.1390652583204233e-01,5.1625590632820217e-01,5.2262117193045099e-01,1.2919702074668089e-02,
1.2624577500958467e+00,1.0582481479606329e+00,1.7581708395789649e-02,2.2497509066486288e-02,3.6384626888162248e-02,1.2627955760105090e+00,6.1673666047603014e-02,4.9444834843583335e-02,7.1063266295253141e-02,4.4655710459341946e-01,4.8241184930839492e-01,1.0684456865260644e-01,2.1568761861596114e-03,5.3930195365051257e-03,4.9694530520959801e-01,
1.2758396847486908e+00,1.0578185487576512e+00,2.4730263401087551e-02,2.5328194157646450e-02,3.7636077234274312e-02,1.2755608746916363e+00,3.1111582993083170e-01,5.2605219450092298e-02,3.0165354368618758e+00,3.2661695532028356e-02,4.8282573040717625e-01,1.0546642532551648e-01,5.5596106349326335e-01,6.8843775209878029e-03,5.2568202194724989e-01,
1.2806689781619067e+00,1.0570612280097240e+00,2.1347229101185833e-02,2.9408437078966822e-02,3.7142257558415478e-02,1.2803363653869677e+00,8.1419718110511852e-02,7.6944808962229772e-02,1.9256646019135168e-01,4.9541379691277776e-01,6.8207350923897458e-02,1.0969417455159128e-01,3.1712108376437164e-03,5.4714144742769910e-01,5.5983497891128209e-01,
1.2865214168023285e+00,1.0563526887525330e+00,2.2458783341471618e-02,2.8644351721524859e-02,3.7742746902036856e-02,1.2857559795320619e+00,4.7035087228679218e-01,5.8683636876751422e-01,6.7896289511568619e-01,3.5860833258949738e-02,7.1050338937726942e-02,1.0983260937250786e-01,5.9038401284004283e-01,5.6615171056706015e-01,6.0701978610122587e-01,

