1
1
15
0
(8 0
((0,0,0) (7,7,7) (0,0,0))
((8,0,0) (15,7,7) (0,0,0))
((0,8,0) (7,15,7) (0,0,0))
((8,8,0) (15,15,7) (0,0,0))
((0,0,8) (7,7,15) (0,0,0))
((8,0,8) (15,7,15) (0,0,0))
((0,8,8) (7,15,15) (0,0,0))
((8,8,8) (15,15,15) (0,0,0))
)
8
FabOnDisk: Cell_D_00000 0
FabOnDisk: Cell_D_00000 61527
FabOnDisk: Cell_D_00000 123055
FabOnDisk: Cell_D_00000 184583
FabOnDisk: Cell_D_00000 246112
FabOnDisk: Cell_D_00000 307640
FabOnDisk: Cell_D_00000 369169
FabOnDisk: Cell_D_00000 430698

8,15
1.14137367785087495e-02,4.07123684530403835e-03,-1.40233391431653122e-02,-9.74634148132861450e-03,-7.28050018128690093e-03,6.27400351568555670e-01,-1.89969008072789929e-03,-8.90996763437495835e-03,-1.93461596919842389e-02,-1.07750833017933867e-02,-2.56951763191483780e-02,-5.64489357343497811e-02,-4.69681203148122395e-01,-4.78640016154017633e-01,-4.92445275267537952e-01,
1.12247525039142447e-02,1.85352709964735395e-03,-7.67799272432260864e-03,-9.80799396897248654e-03,-5.84367761183324230e-03,6.28581585585043623e-01,-2.22905520233498064e-02,-2.80314097891792976e-03,-9.49260056345382561e-03,-4.30584312779125788e-01,-3.14781548296524938e-02,-6.84102842774325093e-02,-4.63312771175062449e-02,-5.24500627589518542e-01,-5.34886097125526483e-01,
1.13996179534572913e-02,1.28000991007034930e-03,-1.47318194693401225e-02,-1.96861280316203233e-03,-4.40572821510747462e-03,6.28305220348261750e-01,-1.49513017417728794e-03,-7.76613740271719834e-03,-1.06640907748459107e-02,-1.48291590329983243e-02,-4.47962451963190844e-01,-7.57569031523610548e-02,-5.18572452939229933e-01,-9.63246441412987375e-02,-5.61444656571142287e-01,
1.12790679013961802e-02,1.96965493052956247e-04,-1.03810371384701096e-02,-3.85647192247035638e-03,-8.66102129177022222e-03,6.27669721066812514e-01,-6.75328531829214318e-02,-5.19415001232166468e-02,-3.46744215187669624e-01,-4.66541408361172139e-01,-4.55282911925456502e-01,-9.13817340820247959e-02,-5.10272766101547495e-02,-1.00144206743851549e-01,-6.07346505308664852e-01,
1.14925090305556515e-02,3.27655997214954323e-04,-1.50059558580034388e-02,-8.68420837104569819e-03,-2.19198810871353011e-04,6.28422287182327954e-01,-1.11201317388553485e-02,-4.01952482070531275e-02,1.05961532804092415e-04,-1.72988090426957966e-02,-4.14666912602826288e-02,-4.40526236431501128e-01,-5.33185712883736285e-01,-5.72799809664368387e-01,-1.63024344139061306e-01,
1.13334844036685461e-02,-2.11055787030067587e-04,-8.00986562142638227e-03,-1.49594854473825336e-02,-1.42456021672012737e-03,6.30322892005349189e-01,-6.73824871997383834e-01,-1.93461690859360802e+00,-3.52352124442986301e-03,-4.79373801500382557e-01,-5.05068493765732165e-02,-4.73166962322227491e-01,-5.07901310030554193e-02,-5.83790096424619986e-01,-1.62805220964753194e-01,
1.15632208916512467e-02,-3.27785536433356048e-04,-1.29509392973482500e-02,-5.67809906679015743e-03,-9.72407520181255169e-04,6.25810754345969888e-01,-6.37446269153181672e-02,-9.43328000846248640e-03,-1.47759166301198088e-02,-2.36786964300300662e-02,-4.53526572623803415e-01,-4.89099146095670678e-01,-5.77020510769900130e-01,-1.01655013761250218e-01,-1.65953006102574130e-01,
1.13989865585502476e-02,-7.23426186349193667e-04,-1.28152013014796624e-02,-9.75873972235870649e-03,-3.70619784052101222e-03,6.24384735064361207e-01,-1.66118009527366078e-02,-7.39660341365065421e-02,-1.98010726635799925e-02,-4.83323458177522980e-01,-4.86776132749548396e-01,-5.11298156635921708e-01,-5.59881082805802621e-02,-1.06200928265368255e-01,-1.68298359207994519e-01,

8,15
1.16037253862113610e+00,1.05794941077562910e+00,1.75479217930232835e-02,2.20098008593271506e-02,2.79638846776974134e-02,1.16444377546644007e+00,1.44242042683336881e-02,1.65858902096487869e-02,1.99105249654118709e-02,4.40166222186009704e-01,4.52938002055078504e-01,4.51629626996989109e-01,1.23670448987351841e-03,2.98994800859880361e-03,6.77532200265489049e-03,
1.21641259595604923e+00,1.05853913218031970e+00,2.21585774251316057e-02,2.19388530932449026e-02,2.79502698102024223e-02,1.21826612305569659e+00,2.19496181005788306e-02,2.12958870110708104e-02,2.01426069365948611e-02,2.96329873961171282e-02,4.71335242736333537e-01,4.82201944845244368e-01,4.39312851550506089e-01,3.84267718510343222e-03,8.64710886691098281e-03,
1.23743723582575438e+00,1.05866247201503061e+00,1.87145094168884932e-02,2.82652928209847429e-02,2.78982882709553695e-02,1.23871724573582465e+00,4.98087242394585905e-02,1.99593104161159274e-02,2.03646908791245904e-02,4.48078882858256755e-01,6.33751839505659748e-02,4.94164076828143672e-01,1.81587998583988396e-03,4.88937749118320775e-01,9.71816773310094431e-03,
1.26374353945086582e+00,1.05821848812760777e+00,2.45652167845814354e-02,2.78535558826201769e-02,2.77768303299920014e-02,1.26394050494391874e+00,1.61602126610388308e-01,1.14556793159386355e-01,2.52950419783151449e-02,3.45907504158301377e-02,6.60600090276124569e-02,5.13905487582767662e-01,5.17686649625021755e-01,5.23908010655958045e-01,1.23379670382600011e-02,
1.26337788436889964e+00,1.05804407451000460e+00,1.74577462484693698e-02,2.26392922818668164e-02,3.62963324109126587e-02,1.26370554036611460e+00,8.38775674738050370e-02,5.19111274095666875e-02,5.25002024515939386e-02,4.46231249124104501e-01,4.80938143217590874e-01,1.04888867930345520e-01,2.17024668591208562e-03,5.26642836285921238e-03,4.99863376726730479e-01,
1.27610187846598766e+00,1.05759651215968953e+00,2.48413157025883236e-02,2.52514306310047607e-02,3.75067386671189551e-02,1.27589082267895759e+00,2.69814614698020816e-01,6.99688694227680180e-02,4.93973361424926094e-01,3.33437913063936234e-02,4.81265609468698952e-01,1.05035910013014114e-01,5.56793718091013745e-01,6.74535650178236055e-03,5.25370069739957368e-01,
1.28092127340753903e+00,1.05686467568786346e+00,2.07319724608525657e-02,2.88468764775067950e-02,3.70233019137064384e-02,1.28059348787110561e+00,6.47707872300046089e-02,6.32867915098206391e-02,1.37154011936738124e-01,4.94985746298068796e-01,6.61335222258813971e-02,1.07464331627091236e-01,3.19689363188654496e-03,5.48622454808879390e-01,5.56564665325363750e-01,
1.28618089126883284e+00,1.05612819602103181e+00,2.21142915943241328e-02,2.82594337355117804e-02,3.78341359608583491e-02,1.28545746508248371e+00,4.42637892382054088e-01,3.28256129313828304e-01,6.33521526160738757e-01,3.67387147789666052e-02,6.97316667531997503e-02,1.08023030767482570e-01,5.90256684537124210e-01,5.64085546907711954e-01,6.05260863723643627e-01,

