1
1
15
0
(8 0
((0,0,0) (7,7,7) (0,0,0))
((8,0,0) (15,7,7) (0,0,0))
((0,8,0) (7,15,7) (0,0,0))
((8,8,0) (15,15,7) (0,0,0))
((0,0,8) (7,7,15) (0,0,0))
((8,0,8) (15,7,15) (0,0,0))
((0,8,8) (7,15,15) (0,0,0))
((8,8,8) (15,15,15) (0,0,0))
)
8
FabOnDisk: Cell_D_00000 0
FabOnDisk: Cell_D_00000 61527
FabOnDisk: Cell_D_00000 123055
FabOnDisk: Cell_D_00000 184583
FabOnDisk: Cell_D_00000 246112
FabOnDisk: Cell_D_00000 307640
FabOnDisk: Cell_D_00000 369169
FabOnDisk: Cell_D_00000 430698

8,15
1.14005158980260077e-02,4.23881126689556673e-03,-1.44970133262451849e-02,-9.37684180062366666e-03,-7.14103195594520054e-03,6.26844416804164029e-01,-2.11105642541203811e-03,-9.84438365174582219e-03,-1.93587806023806583e-02,-1.06657445612489132e-02,-2.60059161188086092e-02,-5.81108530251774127e-02,-4.67225577606142473e-01,-4.75879030591247698e-01,-4.93904103886463219e-01,
1.12107566044732793e-02,1.92394744169016693e-03,-7.75741594497374263e-03,-9.82507943840862583e-03,-5.64817369394444470e-03,6.28943563201723066e-01,-2.19212499341485886e-02,-4.29697217519185888e-03,-1.08199335763242976e-02,-4.29358882653028351e-01,-3.17726786199447747e-02,-7.02415335217677211e-02,-4.71358210354225204e-02,-5.22815646428491099e-01,-5.32077459158003641e-01,
1.13894213114479701e-02,1.31578440513704150e-03,-1.46607288682719175e-02,-1.68664882412388091e-03,-4.29719844739922391e-03,6.28319835857837461e-01,-1.73600723930085834e-03,-7.37102554283312634e-03,-1.05741505519913043e-02,-1.46395492826312812e-02,-4.47274205274602155e-01,-7.89539734367852575e-02,-5.17711157468028649e-01,-9.78365027712865959e-02,-5.59910859895375701e-01,
1.12667148074929759e-02,2.23421623750625438e-04,-1.05311412708543849e-02,-3.90695187669563501e-03,-8.72706091934596570e-03,6.27687647556473216e-01,-5.37102599110018189e-02,-5.14482393492339402e-02,-2.99167282422467817e-01,-4.66123777739891720e-01,-4.54552440048271500e-01,-9.50297239084129941e-02,-5.01362737397804820e-02,-1.01025059445664145e-01,-6.06820948711998764e-01,
1.14824779895633059e-02,3.37825914662261010e-04,-1.50618394666174136e-02,-8.35765411713042077e-03,-2.79364175513108215e-04,6.28446737147978940e-01,-1.16082575047724360e-02,-3.62029832227773601e-02,1.74648087144238344e-04,-1.71831423606999545e-02,-4.24101251011082536e-02,-4.41624122748449033e-01,-5.32720442336073852e-01,-5.73531204460790645e-01,-1.64942171580688385e-01,
1.13203223315457777e-02,-2.78810057054462550e-04,-7.99947287540780927e-03,-1.48390319246332301e-02,-1.09600975604079924e-06,6.30293362857942574e-01,-5.18780108438048337e-01,-1.53221406893949252e+00,3.84780946710094689e-04,-4.79244404960901316e-01,-5.15066790990549445e-02,-4.73502730996828824e-01,-4.97407171214366284e-02,-5.85852312753131432e-01,-1.63411703824603516e-01,
1.15576003287909349e-02,-3.32612774938938574e-04,-1.27327842958971735e-02,-5.18857201650599516e-03,-9.39044073944666244e-04,6.25468841543006304e-01,-2.90074459634088039e-02,-9.75612734865013639e-03,-1.52083972622444261e-02,-2.34837700478163561e-02,-4.52386357458559707e-01,-4.90628340697297827e-01,-5.77718757101899572e-01,-1.04733297687958749e-01,-1.69309599288539891e-01,
1.13909959858886703e-02,-7.65437270266543083e-04,-1.36647097718351068e-02,-1.08919874765795056e-02,-3.43561622675071484e-03,6.24648126580180429e-01,-9.39664165555182396e-02,-3.93616161807146051e-02,-2.02102343924279379e-02,-4.83564351531877323e-01,-4.88099414548868071e-01,-5.11445285840346320e-01,-5.46121778598472468e-02,-1.07396229578977057e-01,-1.70699380001774537e-01,

8,15
1.15620282386819206e+00,1.05802665956742903e+00,1.76993585667193608e-02,2.22597101628948524e-02,2.82349693003182377e-02,1.16044163513508769e+00,1.43306543644428075e-02,1.60058813745754536e-02,1.99907432528308275e-02,4.39455062127941443e-01,4.51872303008831910e-01,4.49284448209245957e-01,1.22547266915827568e-03,3.02577077221377133e-03,6.98763550813843309e-03,
1.21390630936098165e+00,1.05864611496529282e+00,2.21133560040688015e-02,2.21668690266259780e-02,2.82354694115500293e-02,1.21583025680267176e+00,2.14332025876027496e-02,2.09596154735232354e-02,2.02318060753722308e-02,3.01019843898239145e-02,4.71237309599656984e-01,4.80658147132613733e-01,4.36869522619461492e-01,3.87753031372128909e-03,8.89540470147476801e-03,
1.23610938101730961e+00,1.05875008342911281e+00,1.86530702030930848e-02,2.79121213317913286e-02,2.81661857237492409e-02,1.23742516542244663e+00,4.89748512151996288e-02,2.00913800863685744e-02,2.04863534620203479e-02,4.48201172140907433e-01,6.49675581931082047e-02,4.93375451449379554e-01,1.79543298434997004e-03,4.87729864275622593e-01,1.01953326516566294e-02,
1.26308045736812358e+00,1.05826887112618784e+00,2.42070976788092383e-02,2.81290890450015402e-02,2.80637883775411191e-02,1.26330387899187424e+00,1.46213375790975986e-01,1.09324329731292802e-01,2.54030727934238046e-02,3.38694739410473622e-02,6.64036548599672427e-02,5.13906525832042327e-01,5.16255906328202174e-01,5.22621171930450990e-01,1.29197020746680893e-02,
1.26245775009584671e+00,1.05824814796063293e+00,1.75817083957896490e-02,2.24975090664862876e-02,3.63846268881622484e-02,1.26279557601050896e+00,6.16736660476030138e-02,4.94448348435833351e-02,7.10632662952531413e-02,4.46557104593419463e-01,4.82411849308394924e-01,1.06844568652606442e-01,2.15687618615961144e-03,5.39301953650512568e-03,4.96945305209598009e-01,
1.27583968474869081e+00,1.05781854875765124e+00,2.47302634010875509e-02,2.53281941576464498e-02,3.76360772342743122e-02,1.27556087469163626e+00,3.11115829930831700e-01,5.26052194500922984e-02,3.01653543686187575e+00,3.26616955320283564e-02,4.82825730407176246e-01,1.05466425325516477e-01,5.55961063493263352e-01,6.88437752098780293e-03,5.25682021947249889e-01,
1.28066897816190672e+00,1.05706122800972402e+00,2.13472291011858328e-02,2.94084370789668217e-02,3.71422575584154785e-02,1.28033636538696771e+00,8.14197181105118517e-02,7.69448089622297715e-02,1.92566460191351679e-01,4.95413796912777760e-01,6.82073509238974585e-02,1.09694174551591278e-01,3.17121083764371637e-03,5.47141447427699101e-01,5.59834978911282088e-01,
1.28652141680232845e+00,1.05635268875253296e+00,2.24587833414716179e-02,2.86443517215248591e-02,3.77427469020368556e-02,1.28575597953206189e+00,4.70350872286792177e-01,5.86836368767514216e-01,6.78962895115686194e-01,3.58608332589497383e-02,7.10503389377269423e-02,1.09832609372507856e-01,5.90384012840042827e-01,5.66151710567060151e-01,6.07019786101225867e-01,

