1
1
15
0
(8 0
((0,0,0) (7,7,7) (0,0,0))
((8,0,0) (15,7,7) (0,0,0))
((0,8,0) (7,15,7) (0,0,0))
((8,8,0) (15,15,7) (0,0,0))
((0,0,8) (7,7,15) (0,0,0))
((8,0,8) (15,7,15) (0,0,0))
((0,8,8) (7,15,15) (0,0,0))
((8,8,8) (15,15,15) (0,0,0))
)
8
FabOnDisk: Cell_D_00000 0
FabOnDisk: Cell_D_00000 61527
FabOnDisk: Cell_D_00000 123055
FabOnDisk: Cell_D_00000 184583
FabOnDisk: Cell_D_00000 246112
FabOnDisk: Cell_D_00000 307640
FabOnDisk: Cell_D_00000 369169
FabOnDisk: Cell_D_00000 430698

8,15
1.2269265593588178e-02,2.2285187640934144e-02,-1.3679105805057955e-02,-1.3316002459408277e-02,-7.0497290085999066e-03,6.2862560597740880e-01,-2.0850471015296593e-03,5.0036432103428953e-04,1.5391925953086867e-03,-1.0000075103850795e-02,-3.2506690061567735e-02,-9.9763200494706022e-02,-3.8213660104505220e-01,-4.3559540695736620e-01,-4.8780260742764192e-01,
1.2058502031497416e-02,8.9206033305586178e-03,-9.5826367535188708e-03,-1.3120158676297147e-02,-6.2269502511503993e-03,6.2910977871443596e-01,-1.0173979494152705e-02,1.1225213763390581e-04,-1.0921429908609805e-02,-3.8008758290864031e-01,-4.1442736129303007e-02,-1.2442591970039502e-01,-7.1735142163859011e-02,-4.6801716063213711e-01,-5.3513456024188799e-01,
1.2088445053796490e-02,3.6334092112190997e-03,-1.4109533233425058e-02,-7.1147589236974004e-03,-7.0263956509312268e-03,6.2846222270298679e-01,-1.4915135402699877e-03,-6.4823513176741811e-03,-4.0380413644819618e-02,-1.6133375479788915e-02,-4.1945341192594171e-01,-1.5322982341437108e-01,-4.7774823055340687e-01,-1.5122411031333965e-01,-5.6216638049014067e-01,
1.2109509224559088e-02,1.4399780557246766e-03,-1.1954853438169894e-02,-8.9060917942030311e-03,-9.8713597992287887e-03,6.2823216697975348e-01,-2.4995404415877651e-02,-6.4311546431346763e-03,-3.5295048116580865e-02,-4.4566009323431938e-01,-4.2767413182682024e-01,-1.8806125218048289e-01,-7.4364696951764980e-02,-1.5274659331838680e-01,-5.6811457323477488e-01,
1.2146927062596288e-02,1.2255183147331090e-03,-1.2503494044248158e-02,-1.1801960416141614e-02,-5.5294568471027884e-03,6.2948335737691785e-01,-3.4190470294126513e-03,-2.2782708444392938e-02,-5.5035734022800898e-03,-2.0707675657871405e-02,-6.7154982861252877e-02,-4.5116526608701696e-01,-5.3231114921966616e-01,-5.5449885479207606e-01,-2.4274725409878997e-01,
1.2172391827297301e-02,-4.0440470282269974e-05,-1.3978954996987704e-02,-1.0933449751816341e-02,-7.1550054318715584e-03,6.2792589694330547e-01,-6.4394991907519528e-01,-2.1811594335660796e+00,-1.2178466818944357e-01,-4.6813516539822830e-01,-8.4574085551114786e-02,-4.7216836474053525e-01,-7.3132291300391256e-02,-6.0598336227656380e-01,-2.4334406266217604e-01,
1.2242846629465993e-02,-4.0273194570453977e-04,-1.2470696959705558e-02,-9.8246180000990391e-03,-6.6992184296371781e-03,6.2701907365559439e-01,-2.5799450916877881e-02,-1.5040233884805508e-02,-4.2742467323533359e-02,-3.2745687935935311e-02,-4.7566869020935615e-01,-4.7987450682840260e-01,-5.6297135454295222e-01,-1.5538468276459003e-01,-2.4411512992609588e-01,
1.2302441320952191e-02,-7.2774555488086220e-04,-1.6282711545700983e-02,-1.3282121747209014e-02,-8.7053057136540022e-03,6.2626588940864913e-01,-4.2829829286727530e-02,-1.6649445279998822e-02,-2.7205253968038245e-02,-4.7345402831854944e-01,-5.0596025070971007e-01,-4.7932531496501185e-01,-7.6984825529175321e-02,-1.5649664186485474e-01,-2.4607740634185676e-01,

8,15
9.5541246828502169e-01,1.0555259622123061e+00,1.5349588019666117e-02,1.8320214550658961e-02,2.2517557839982855e-02,1.0678087738327264e+00,1.3336981342868141e-02,1.1257162170217567e-02,1.1987401150754340e-02,3.9031106551246914e-01,4.1094081333940041e-01,4.5397550528277009e-01,1.1138681884084148e-03,3.7059209582254579e-03,1.3365069172895802e-02,
1.0765990286283234e+00,1.0564135558934615e+00,1.9491349357445301e-02,1.9761517639444132e-02,2.3654057959630253e-02,1.0855196319588820e+00,7.3050970156317632e-03,1.2605393106606671e-02,1.5193281470472136e-02,4.6760717732979691e-02,4.1420646801877253e-01,4.6849146285078180e-01,3.8775980474914556e-01,4.9744562227047248e-03,1.8125397473967665e-02,
1.1652954284742154e+00,1.0562302599271300e+00,1.7553817634910283e-02,2.4565221880864681e-02,2.2774197922113257e-02,1.1689288376854345e+00,1.5424739487343910e-02,8.4507503162759880e-03,1.5218418027041356e-02,4.4787149181292563e-01,9.7158432930512878e-02,4.7036653851310573e-01,1.9323985444912712e-03,4.3489953283930533e-01,2.4142627193707456e-02,
1.2301484883378428e+00,1.0559029162288338e+00,1.9866053205600635e-02,2.4758081121582481e-02,2.5178937292792854e-02,1.2315884663935674e+00,3.4069690234343017e-02,1.0370134864909472e-02,1.7846718678629591e-02,4.8471092345358333e-02,9.7441852423494360e-02,4.7133399324229741e-01,4.7058617770642719e-01,4.7685393521729857e-01,3.2518025142983714e-02,
1.2383322752397397e+00,1.0558159590038656e+00,1.9449308553074786e-02,1.9574127260349225e-02,2.6208736193185051e-02,1.2395577935544728e+00,4.1257912365961505e-02,1.7727895577283360e-02,2.6162087600603273e-02,4.6397263674998612e-01,4.8729921627582079e-01,1.5504839262505560e-01,2.5301577437172708e-03,8.6295630558125124e-03,4.8018819740056007e-01,
1.2705433289167647e+00,1.0554763183908842e+00,1.9162525871065025e-02,2.2215936144694710e-02,2.6089428545987954e-02,1.2705028884464824e+00,6.0110343764735963e-01,1.9318775021936203e-02,8.6985542445521047e-01,4.8060261232261411e-02,5.0765562262716535e-01,1.5560197935346518e-01,5.3170309389423598e-01,1.1557914115477165e-02,5.3411747755603278e-01,
1.2837125004122623e+00,1.0547158542156740e+00,2.0521418961265647e-02,2.4231960830167369e-02,2.5039883734549309e-02,1.2833196820066026e+00,6.2683756824829712e-02,9.0099799130205202e-02,1.2701666969397707e-01,4.7236793258598020e-01,9.9245020226012559e-02,1.5679880009244698e-01,4.4134754901754645e-03,5.3385250832318532e-01,5.7123006122493514e-01,
1.2910003117487279e+00,1.0537040248130909e+00,1.8026989016045471e-02,2.3711497473222584e-02,2.5017990875052805e-02,1.2903014784230566e+00,1.4380782937670467e-01,2.1084159545509751e-01,1.8154078096230264e-01,5.0183097673931212e-02,1.0036427132908696e-01,1.5724541378180792e-01,5.7605996797632497e-01,5.9712681485121877e-01,5.8491775612683605e-01,

