1
1
15
0
(8 0
((0,0,0) (7,7,7) (0,0,0))
((8,0,0) (15,7,7) (0,0,0))
((0,8,0) (7,15,7) (0,0,0))
((8,8,0) (15,15,7) (0,0,0))
((0,0,8) (7,7,15) (0,0,0))
((8,0,8) (15,7,15) (0,0,0))
((0,8,8) (7,15,15) (0,0,0))
((8,8,8) (15,15,15) (0,0,0))
)
8
FabOnDisk: Cell_D_00000 0
FabOnDisk: Cell_D_00000 61527
FabOnDisk: Cell_D_00000 123055
FabOnDisk: Cell_D_00000 184583
FabOnDisk: Cell_D_00000 246112
FabOnDisk: Cell_D_00000 307640
FabOnDisk: Cell_D_00000 369169
FabOnDisk: Cell_D_00000 430698

8,15
1.22692655935881783e-02,2.22851876409341440e-02,-1.36791058050579548e-02,-1.33160024594082774e-02,-7.04972900859990662e-03,6.28625605977408797e-01,-2.08504710152965927e-03,5.00364321034289534e-04,1.53919259530868667e-03,-1.00000751038507949e-02,-3.25066900615677348e-02,-9.97632004947060225e-02,-3.82136601045052204e-01,-4.35595406957366205e-01,-4.87802607427641921e-01,
1.20585020314974162e-02,8.92060333055861784e-03,-9.58263675351887084e-03,-1.31201586762971466e-02,-6.22695025115039928e-03,6.29109778714435963e-01,-1.01739794941527045e-02,1.12252137633905814e-04,-1.09214299086098053e-02,-3.80087582908640309e-01,-4.14427361293030067e-02,-1.24425919700395016e-01,-7.17351421638590114e-02,-4.68017160632137108e-01,-5.35134560241887991e-01,
1.20884450537964896e-02,3.63340921121909971e-03,-1.41095332334250576e-02,-7.11475892369740036e-03,-7.02639565093122684e-03,6.28462222702986795e-01,-1.49151354026998769e-03,-6.48235131767418114e-03,-4.03804136448196183e-02,-1.61333754797889153e-02,-4.19453411925941710e-01,-1.53229823414371080e-01,-4.77748230553406872e-01,-1.51224110313339655e-01,-5.62166380490140671e-01,
1.21095092245590875e-02,1.43997805572467657e-03,-1.19548534381698941e-02,-8.90609179420303113e-03,-9.87135979922878874e-03,6.28232166979753481e-01,-2.49954044158776506e-02,-6.43115464313467628e-03,-3.52950481165808655e-02,-4.45660093234319377e-01,-4.27674131826820236e-01,-1.88061252180482891e-01,-7.43646969517649803e-02,-1.52746593318386803e-01,-5.68114573234774878e-01,
1.21469270625962876e-02,1.22551831473310903e-03,-1.25034940442481576e-02,-1.18019604161416145e-02,-5.52945684710278839e-03,6.29483357376917851e-01,-3.41904702941265128e-03,-2.27827084443929379e-02,-5.50357340228008977e-03,-2.07076756578714050e-02,-6.71549828612528765e-02,-4.51165266087016958e-01,-5.32311149219666158e-01,-5.54498854792076057e-01,-2.42747254098789972e-01,
1.21723918272973013e-02,-4.04404702822699737e-05,-1.39789549969877042e-02,-1.09334497518163414e-02,-7.15500543187155835e-03,6.27925896943305473e-01,-6.43949919075195276e-01,-2.18115943356607955e+00,-1.21784668189443571e-01,-4.68135165398228303e-01,-8.45740855511147860e-02,-4.72168364740535251e-01,-7.31322913003912556e-02,-6.05983362276563797e-01,-2.43344062662176036e-01,
1.22428466294659932e-02,-4.02731945704539775e-04,-1.24706969597055579e-02,-9.82461800009903907e-03,-6.69921842963717810e-03,6.27019073655594394e-01,-2.57994509168778807e-02,-1.50402338848055084e-02,-4.27424673235333591e-02,-3.27456879359353109e-02,-4.75668690209356149e-01,-4.79874506828402603e-01,-5.62971354542952218e-01,-1.55384682764590026e-01,-2.44115129926095881e-01,
1.23024413209521909e-02,-7.27745554880862198e-04,-1.62827115457009827e-02,-1.32821217472090143e-02,-8.70530571365400220e-03,6.26265889408649135e-01,-4.28298292867275304e-02,-1.66494452799988216e-02,-2.72052539680382455e-02,-4.73454028318549436e-01,-5.05960250709710069e-01,-4.79325314965011851e-01,-7.69848255291753214e-02,-1.56496641864854735e-01,-2.46077406341856764e-01,

8,15
9.55412468285021688e-01,1.05552596221230610e+00,1.53495880196661168e-02,1.83202145506589607e-02,2.25175578399828547e-02,1.06780877383272643e+00,1.33369813428681414e-02,1.12571621702175668e-02,1.19874011507543395e-02,3.90311065512469135e-01,4.10940813339400413e-01,4.53975505282770087e-01,1.11386818840841480e-03,3.70592095822545788e-03,1.33650691728958021e-02,
1.07659902862832335e+00,1.05641355589346153e+00,1.94913493574453006e-02,1.97615176394441323e-02,2.36540579596302529e-02,1.08551963195888201e+00,7.30509701563176322e-03,1.26053931066066709e-02,1.51932814704721364e-02,4.67607177329796911e-02,4.14206468018772533e-01,4.68491462850781804e-01,3.87759804749145565e-01,4.97445622270472482e-03,1.81253974739676652e-02,
1.16529542847421541e+00,1.05623025992713004e+00,1.75538176349102834e-02,2.45652218808646815e-02,2.27741979221132568e-02,1.16892883768543454e+00,1.54247394873439098e-02,8.45075031627598797e-03,1.52184180270413562e-02,4.47871491812925626e-01,9.71584329305128780e-02,4.70366538513105725e-01,1.93239854449127118e-03,4.34899532839305325e-01,2.41426271937074562e-02,
1.23014848833784285e+00,1.05590291622883381e+00,1.98660532056006353e-02,2.47580811215824814e-02,2.51789372927928544e-02,1.23158846639356745e+00,3.40696902343430169e-02,1.03701348649094718e-02,1.78467186786295910e-02,4.84710923453583326e-02,9.74418524234943600e-02,4.71333993242297411e-01,4.70586177706427189e-01,4.76853935217298575e-01,3.25180251429837142e-02,
1.23833227523973965e+00,1.05581595900386560e+00,1.94493085530747858e-02,1.95741272603492250e-02,2.62087361931850511e-02,1.23955779355447282e+00,4.12579123659615049e-02,1.77278955772833605e-02,2.61620876006032725e-02,4.63972636749986123e-01,4.87299216275820790e-01,1.55048392625055598e-01,2.53015774371727082e-03,8.62956305581251241e-03,4.80188197400560068e-01,
1.27054332891676469e+00,1.05547631839088418e+00,1.91625258710650254e-02,2.22159361446947097e-02,2.60894285459879541e-02,1.27050288844648240e+00,6.01103437647359629e-01,1.93187750219362027e-02,8.69855424455210469e-01,4.80602612322614114e-02,5.07655622627165348e-01,1.55601979353465175e-01,5.31703093894235979e-01,1.15579141154771650e-02,5.34117477556032783e-01,
1.28371250041226226e+00,1.05471585421567404e+00,2.05214189612656465e-02,2.42319608301673692e-02,2.50398837345493092e-02,1.28331968200660262e+00,6.26837568248297117e-02,9.00997991302052020e-02,1.27016669693977069e-01,4.72367932585980199e-01,9.92450202260125591e-02,1.56798800092446983e-01,4.41347549017546449e-03,5.33852508323185315e-01,5.71230061224935137e-01,
1.29100031174872787e+00,1.05370402481309089e+00,1.80269890160454707e-02,2.37114974732225842e-02,2.50179908750528049e-02,1.29030147842305665e+00,1.43807829376704666e-01,2.10841595455097508e-01,1.81540780962302639e-01,5.01830976739312123e-02,1.00364271329086957e-01,1.57245413781807925e-01,5.76059967976324971e-01,5.97126814851218768e-01,5.84917756126836053e-01,

