1
1
15
0
(8 0
((0,0,0) (7,7,7) (0,0,0))
((8,0,0) (15,7,7) (0,0,0))
((0,8,0) (7,15,7) (0,0,0))
((8,8,0) (15,15,7) (0,0,0))
((0,0,8) (7,7,15) (0,0,0))
((8,0,8) (15,7,15) (0,0,0))
((0,8,8) (7,15,15) (0,0,0))
((8,8,8) (15,15,15) (0,0,0))
)
8
FabOnDisk: Cell_D_00000 0
FabOnDisk: Cell_D_00000 61527
FabOnDisk: Cell_D_00000 123055
FabOnDisk: Cell_D_00000 184583
FabOnDisk: Cell_D_00000 246112
FabOnDisk: Cell_D_00000 307640
FabOnDisk: Cell_D_00000 369169
FabOnDisk: Cell_D_00000 430698

8,15
1.22706186386552629e-02,2.06815046700954790e-02,-1.39135620748791558e-02,-1.31785890754976265e-02,-7.41329555878631787e-03,6.28821960182611717e-01,-2.08643280854331915e-03,3.90414027137884828e-04,1.47141946505519950e-03,-1.02627747434979964e-02,-3.20548621757190469e-02,-9.69255349711729691e-02,-3.84678562055766116e-01,-4.37295891968493777e-01,-4.90586415218504768e-01,
1.20601816984549116e-02,8.17819590727402422e-03,-9.69776997530735416e-03,-1.30412185429973054e-02,-6.60561325515336348e-03,6.29149077570886561e-01,-9.84119646260287612e-03,3.67544235266274591e-05,-1.37641708351481217e-02,-3.83824757929015770e-01,-4.09032945987698252e-02,-1.21058696785867920e-01,-7.23567619608459084e-02,-4.68022058124613338e-01,-5.36121301387954663e-01,
1.20890322225498410e-02,3.45194608677508539e-03,-1.40840678846732414e-02,-7.11618373499917252e-03,-7.30188811091518619e-03,6.28512427609411617e-01,-1.51348350150460925e-03,-6.07307631803749755e-03,-4.01110031036653325e-02,-1.64454132926890768e-02,-4.20834281467196036e-01,-1.48020885642148659e-01,-4.80799250157054214e-01,-1.48519829947118487e-01,-5.59964580686588276e-01,
1.21103830212047174e-02,1.35182324169324706e-03,-1.21217556493881783e-02,-8.46489721255157257e-03,-9.67037564683801559e-03,6.28217819416459045e-01,-2.68162246627226819e-02,-6.08185552446614559e-03,-3.40275369634050195e-02,-4.47211070330134075e-01,-4.29137675767026272e-01,-1.82053895808016397e-01,-7.48336240837070843e-02,-1.50344939491076551e-01,-5.64648697547085132e-01,
1.21464672876807674e-02,1.17292375629131211e-03,-1.25023706341268730e-02,-1.16089264812217104e-02,-5.46405093166657703e-03,6.29373571209920213e-01,-5.17674159875525491e-03,-2.14402544486558475e-02,-5.62849067114382963e-03,-2.10367551580363417e-02,-6.54700397084511804e-02,-4.51252426896552983e-01,-5.34042138925139520e-01,-5.56537139730037711e-01,-2.38994835159069302e-01,
1.21740131596131326e-02,-3.25462723089240091e-07,-1.40151387385313991e-02,-1.07476137982714104e-02,-7.28366711487844418e-03,6.27856497903271915e-01,-7.18605175120333506e-01,-3.44293390079036410e+00,-9.02866707875026389e-03,-4.68555857576181956e-01,-8.24880756071244559e-02,-4.73330918687963342e-01,-7.33134822152531340e-02,-6.06593743690780007e-01,-2.39731881186936724e-01,
1.22390167590217033e-02,-3.99834194051546920e-04,-1.25733125833827515e-02,-9.95235029524571199e-03,-6.58893088190925635e-03,6.27188896015523856e-01,-2.64317783729336869e-02,-1.47871152382927449e-02,-5.51759092047604260e-02,-3.30388393422154647e-02,-4.74481124805787413e-01,-4.82132565884365871e-01,-5.63318796666621546e-01,-1.52531392597799159e-01,-2.40193076194661626e-01,
1.22980982107188559e-02,-7.41030846153363683e-04,-1.65295231445797899e-02,-1.36056463903504385e-02,-8.78285390143696172e-03,6.26743239421092002e-01,-4.46721441487350490e-02,-1.66001951773777773e-02,-2.64468261031494539e-02,-4.73129021755869517e-01,-5.05651830735511343e-01,-4.81545440770309974e-01,-7.76757382678906205e-02,-1.53971221646353851e-01,-2.42182903625489221e-01,

8,15
9.66872936801951299e-01,1.05551318823777396e+00,1.53939186760993843e-02,1.81214784689290587e-02,2.23880961690921913e-02,1.06779870247381803e+00,1.31274585007492908e-02,1.07278474411987394e-02,1.20788997156430038e-02,3.93452077088844332e-01,4.09725410815117264e-01,4.54342359427584441e-01,1.14398558092172861e-03,3.65423203836848795e-03,1.28520744652825623e-02,
1.08631802982896897e+00,1.05640292387627222e+00,1.97312329036923167e-02,1.97146736933317412e-02,2.35939752897571693e-02,1.09449622573624294e+00,7.67126759406938641e-03,1.22091350541144901e-02,1.55000689498296512e-02,4.70467964329047486e-02,4.18627194834886751e-01,4.67095272749918355e-01,3.90373425157987008e-01,4.90990301051515577e-03,1.74326031154910625e-02,
1.16974729592303595e+00,1.05621653247665970e+00,1.77374038140136470e-02,2.45984499111049602e-02,2.26384461871340023e-02,1.17319924200981096e+00,1.50426434050053466e-02,8.53572257616960761e-03,1.51707324917547265e-02,4.49076148249589746e-01,9.55443457004182123e-02,4.67998400737228037e-01,1.97172260038255181e-03,4.37324302620012872e-01,2.29457467717818289e-02,
1.23294527867609327e+00,1.05588717196207860e+00,1.98638309051883469e-02,2.48053938771750394e-02,2.50310546995574819e-02,1.23429710191778641e+00,3.66970461422539140e-02,1.05304351593195015e-02,1.78666676848519973e-02,4.87897210390030658e-02,9.59427919391146605e-02,4.75072443463695093e-01,4.74232687403541020e-01,4.79423933845811556e-01,3.09169557146235854e-02,
1.24023315453832272e+00,1.05580830892298039e+00,1.95210511994484102e-02,1.98999911802672062e-02,2.63066011281052961e-02,1.24140607829461413e+00,3.96734699283797926e-02,1.80675869097140472e-02,2.54355062698908910e-02,4.64391262215935019e-01,4.88059384054724710e-01,1.52620941019890877e-01,2.57473129749824677e-03,8.39909351240133301e-03,4.79862769562442282e-01,
1.27145926095655115e+00,1.05547594060133632e+00,1.91412927776793938e-02,2.22967241845345582e-02,2.61878610667232656e-02,1.27145893549382816e+00,6.10113280799729596e-01,1.96082198682970971e-02,1.14840128287996035e+00,4.82024936100765855e-02,5.07195739952050584e-01,1.53307109728184982e-01,5.33692240826419639e-01,1.12562681468465556e-02,5.34894040234066503e-01,
1.28392014111765240e+00,1.05472780700783031e+00,2.08297430538578465e-02,2.43080239662255143e-02,2.52090855408318125e-02,1.28352030692360075e+00,6.54259597960051009e-02,8.98556636987321855e-02,9.59430240802706946e-02,4.72453193204532218e-01,9.74044921813504577e-02,1.54326105347284470e-01,4.45623231047677718e-03,5.31943991366798596e-01,5.72214000696850800e-01,
1.29115116502061000e+00,1.05372683864901306e+00,1.82646326845873272e-02,2.37394731652458765e-02,2.51258418443275899e-02,1.29043978907668810e+00,1.37537564732691742e-01,1.80771424707619643e-01,1.65127824683252489e-01,5.04813963145152381e-02,9.86932741166438032e-02,1.54840099107671880e-01,5.75605011952730949e-01,5.96312905763656254e-01,5.88636820675428774e-01,

