1
1
15
0
(8 0
((0,0,0) (7,7,7) (0,0,0))
((8,0,0) (15,7,7) (0,0,0))
((0,8,0) (7,15,7) (0,0,0))
((8,8,0) (15,15,7) (0,0,0))
((0,0,8) (7,7,15) (0,0,0))
((8,0,8) (15,7,15) (0,0,0))
((0,8,8) (7,15,15) (0,0,0))
((8,8,8) (15,15,15) (0,0,0))
)
8
FabOnDisk: Cell_D_00000 0
FabOnDisk: Cell_D_00000 61527
FabOnDisk: Cell_D_00000 123055
FabOnDisk: Cell_D_00000 184583
FabOnDisk: Cell_D_00000 246112
FabOnDisk: Cell_D_00000 307640
FabOnDisk: Cell_D_00000 369169
FabOnDisk: Cell_D_00000 430698

8,15
1.2252444207002581e-02,1.9189620562325652e-02,-1.4016373250874525e-02,-1.2936102332449946e-02,-7.0167572907288596e-03,6.2905728618405776e-01,-2.1341725992789677e-03,7.0091235296451909e-04,1.8753156454464272e-03,-1.0042224642270337e-02,-3.1838966283292372e-02,-9.5372451472265057e-02,-3.8495276669394540e-01,-4.3938985752467830e-01,-4.9360674171700747e-01,
1.2045199939790550e-02,7.6268250033337042e-03,-9.4906690312354172e-03,-1.2804998106205513e-02,-6.0090673400753965e-03,6.2897026339591156e-01,-9.8526437511939468e-03,-2.6197519838892010e-04,-1.5281257842953092e-02,-3.8477245109565661e-01,-4.0463149175602509e-02,-1.1874495582286931e-01,-7.0115521914947923e-02,-4.6811247116371640e-01,-5.3681010499043147e-01,
1.2078503681898001e-02,3.2632047947263182e-03,-1.4046096475262575e-02,-6.6013179208945748e-03,-6.7363276860724058e-03,6.2866913708455485e-01,-1.4652300450689888e-03,-5.6978393791316632e-03,-3.9424948269059276e-02,-1.5991463114648347e-02,-4.2225196881582427e-01,-1.4534702651172282e-01,-4.8369617730920123e-01,-1.4660156400237823e-01,-5.5863947432096084e-01,
1.2098529859958485e-02,1.2839734397254066e-03,-1.2177186641494111e-02,-8.0847020528469170e-03,-9.2760529089565315e-03,6.2831638289128255e-01,-2.8020598081633249e-02,-5.9958321584501250e-03,-3.3064323128242895e-02,-4.4783690654526459e-01,-4.3040351110064146e-01,-1.7831271254712383e-01,-7.2385817866442839e-02,-1.4853383373916262e-01,-5.6210304314133019e-01,
1.2134849193854132e-02,1.1031033659417886e-03,-1.2335512561563310e-02,-1.1278395220781584e-02,-5.0380836833068578e-03,6.2942474829701334e-01,-5.8050955777305489e-03,-2.0442093544621960e-02,-5.2161813012634754e-03,-2.0404036212948135e-02,-6.4623200293790900e-02,-4.5182005748885012e-01,-5.3461802329783026e-01,-5.5916361667290804e-01,-2.3600266317740970e-01,
1.2159727810853158e-02,-3.7485732731128164e-05,-1.3343620756780682e-02,-1.0783321850227592e-02,-6.6312513131425201e-03,6.2764209317951858e-01,-6.3698096491024259e-02,-6.8097988835164713e-01,-8.9447365727871944e-03,-4.6944656517596162e-01,-8.1118212642233622e-02,-4.7415828626999235e-01,-7.0937457851186353e-02,-6.0716791662166503e-01,-2.3692141450086493e-01,
1.2226780418112822e-02,-4.0067029309524994e-04,-1.2469352542270440e-02,-1.0077443618161319e-02,-6.1240904771284639e-03,6.2718749623416303e-01,-2.8297706492409848e-02,-1.4441112378717529e-02,-9.6704393984385406e-02,-3.1874219617057331e-02,-4.7451805942415520e-01,-4.8370139932940642e-01,-5.6064303695387419e-01,-1.5114264392136370e-01,-2.3813459469163115e-01,
1.2283747098182080e-02,-7.5126714918975334e-04,-1.6712283076595280e-02,-1.3773397014413383e-02,-8.2337654004277800e-03,6.2728051458809109e-01,-4.4277258036921771e-02,-1.6728710054982929e-02,-2.6114091890033039e-02,-4.7455538626177629e-01,-5.0558869834762943e-01,-4.8350613854870567e-01,-7.5378700777207874e-02,-1.5230629861021808e-01,-2.3987540061247192e-01,

8,15
9.7778150921462037e-01,1.0555921817295424e+00,1.5612766071238182e-02,1.8771224916527302e-02,2.3218579984196335e-02,1.0678612191987038e+00,1.3277540816871563e-02,1.0564027660444552e-02,1.2728333994143705e-02,3.9685566392282451e-01,4.0910853561462335e-01,4.5503638931523482e-01,1.1200369320062391e-03,3.6299390706625184e-03,1.2566519757651967e-02,
1.0937489475583007e+00,1.0564660419132823e+00,2.0050350784920595e-02,2.0117983803396390e-02,2.4125072806549196e-02,1.1013757725616344e+00,7.7959724478943275e-03,1.1910250878446639e-02,1.6160031577582255e-02,4.5505055703960226e-02,4.2205155776226111e-01,4.6609950041688608e-01,3.9326212030000135e-01,4.8560585150993468e-03,1.6955622702478735e-02,
1.1746076931907572e+00,1.0562555526105404e+00,1.8011627081481921e-02,2.4790954215660466e-02,2.3230790987948891e-02,1.1778708979854835e+00,1.4840764112391342e-02,8.7532704846682036e-03,1.5378489316458162e-02,4.4974356023225220e-01,9.4337009727745946e-02,4.6624344333613010e-01,1.9192792704012679e-03,4.4017620479718916e-01,2.2319670892743428e-02,
1.2351499445259759e+00,1.0559303804605302e+00,2.0097810427228691e-02,2.5119471258763629e-02,2.5549909566160177e-02,1.2364339179657013e+00,3.8346896014415453e-02,1.2177460558150464e-02,1.8464540067274198e-02,4.7231681589673703e-02,9.4794613595494862e-02,4.7814156989149237e-01,4.7532492645987023e-01,4.8159125182509255e-01,2.9916841060353503e-02,
1.2422927911644461e+00,1.0558382999384635e+00,1.9645404943463562e-02,2.0450353537864993e-02,2.7108986526219001e-02,1.2433958945303880e+00,4.5718327014953070e-02,1.8550722618483579e-02,2.7282950122415328e-02,4.6331837158291800e-01,4.8918109718764058e-01,1.5088191151191657e-01,2.5001811979293571e-03,8.2859713546721194e-03,4.8079158721264892e-01,
1.2720341214444983e+00,1.0555079450014990e+00,1.9345980016850940e-02,2.2884179467560894e-02,2.6964922497584299e-02,1.2719966357117671e+00,3.7300248565292932e-02,2.0045923425048254e-02,1.1049336019721066e-01,4.6751751818116138e-02,5.0705463592783262e-01,1.5165970366340556e-01,5.3463313120441869e-01,1.1052883193629265e-02,5.3553609222069687e-01,
1.2841132214908211e+00,1.0547692632352181e+00,2.1218429216199736e-02,2.4509142915302810e-02,2.5806698678778269e-02,1.2837125511977259e+00,6.6822835636558137e-02,1.3239721166807700e-01,1.0463065388595570e-01,4.7528448186139777e-01,9.6607621296573715e-02,1.5295587100856206e-01,4.3026035485750902e-03,5.3232836844942555e-01,5.7368422935529439e-01,
1.2910983553391149e+00,1.0538108735187035e+00,1.8470698873391613e-02,2.3935132812775137e-02,2.5951084907848455e-02,1.2903904922788001e+00,1.3749972578483308e-01,1.7887107125453927e-01,1.7097363933962306e-01,4.8975450021656361e-02,9.7737686040594213e-02,1.5332714071697812e-01,5.7792481406424845e-01,5.9609188690963100e-01,5.9113417031868476e-01,

