1
1
15
0
(8 0
((0,0,0) (7,7,7) (0,0,0))
((8,0,0) (15,7,7) (0,0,0))
((0,8,0) (7,15,7) (0,0,0))
((8,8,0) (15,15,7) (0,0,0))
((0,0,8) (7,7,15) (0,0,0))
((8,0,8) (15,7,15) (0,0,0))
((0,8,8) (7,15,15) (0,0,0))
((8,8,8) (15,15,15) (0,0,0))
)
8
FabOnDisk: Cell_D_00000 0
FabOnDisk: Cell_D_00000 61527
FabOnDisk: Cell_D_00000 123055
FabOnDisk: Cell_D_00000 184583
FabOnDisk: Cell_D_00000 246112
FabOnDisk: Cell_D_00000 307640
FabOnDisk: Cell_D_00000 369169
FabOnDisk: Cell_D_00000 430698

8,15
1.22542449563279050e-02,1.78143074208452663e-02,-1.41792302970438992e-02,-1.27717368859753076e-02,-7.36841445323877832e-03,6.28470736424683318e-01,-2.11379763120495869e-03,5.42139320033853444e-04,1.92326817880943742e-03,-1.03014086655051993e-02,-3.13950071895175431e-02,-9.26134616435631552e-02,-3.87058270654511594e-01,-4.40538473053006308e-01,-4.95810384335964027e-01,
1.20479763340167450e-02,6.99346100970102327e-03,-9.54044631286932523e-03,-1.26925962366985466e-02,-6.40095030218023470e-03,6.28839705459091514e-01,-9.70267724442250984e-03,-1.62072831770858523e-03,-1.46603273647640808e-02,-3.88335123894599843e-01,-3.99357837748368777e-02,-1.15477640443252108e-01,-7.05697115793288143e-02,-4.67397597441092938e-01,-5.37095677473656163e-01,
1.20795298397061608e-02,3.07173192766956862e-03,-1.39935698639721585e-02,-6.88817619067270525e-03,-7.01378884245295632e-03,6.28737549610170365e-01,-1.55193429266646771e-03,-3.87225347655132963e-03,-3.38488448769482947e-02,-1.62948765167583512e-02,-4.23571051471845816e-01,-1.40299775138762600e-01,-4.86518212805376937e-01,-1.43971109228343330e-01,-5.56137150793229007e-01,
1.20996303854103010e-02,1.18095657050898873e-03,-1.23307533816123336e-02,-7.63021869346775915e-03,-9.04064223402976409e-03,6.28299498981772064e-01,-4.37093346390674126e-02,-6.29994352285561613e-03,-3.31670901671004617e-02,-4.49286230989329349e-01,-4.31805928110820081e-01,-1.72481855367032560e-01,-7.28013787270111179e-02,-1.46099329978296222e-01,-5.58400942622974017e-01,
1.21353121093684437e-02,9.99042017607872090e-04,-1.23128869398800595e-02,-1.10239694968953111e-02,-5.14693269589885927e-03,6.29161757053206983e-01,-5.53375482976233533e-03,-1.73786738001373703e-02,-5.55530545059225098e-03,-2.07214421939128438e-02,-6.30041748167242399e-02,-4.51804597623490400e-01,-5.36209826904708864e-01,-5.60778257369592859e-01,-2.32254135430154829e-01,
1.21603216736969680e-02,-4.55830819655943329e-04,-1.39252988550647785e-02,-1.11345045988618697e-02,-6.48575790733425892e-03,6.27501300185416166e-01,-1.05721458543028746e+00,-2.17651224002118493e+00,-9.04819592904682057e-03,-4.69839728741379414e-01,-7.91759210167819055e-02,-4.75183169291154173e-01,-7.10066396275994827e-02,-6.07310510030080186e-01,-2.33325103491113572e-01,
1.22244268925187274e-02,-3.99866941299460059e-04,-1.25056255727118253e-02,-1.01545597951363566e-02,-6.10760265737429406e-03,6.27831464105593096e-01,-3.14670234559619871e-02,-2.20714841310499926e-02,-6.79203739449757649e-01,-3.21535383203744446e-02,-4.73235531159937217e-01,-4.85630900367862606e-01,-5.60818964831405919e-01,-1.48264147035851335e-01,-2.34560371181385008e-01,
1.22808573961339373e-02,-7.20141256567736121e-04,-1.69195952570862576e-02,-1.40326480555896613e-02,-8.32437117444077487e-03,6.28282241131031594e-01,-4.51251246480250945e-02,-1.66287402663456083e-02,-2.54002665654056922e-02,-4.74225884516907892e-01,-5.05158114853954565e-01,-4.86327650341533968e-01,-7.60581518613797913e-02,-1.49825312845428132e-01,-2.36081307860680656e-01,

8,15
9.88374605518115290e-01,1.05558307783451655e+00,1.56541007020113351e-02,1.85775453341474675e-02,2.30667199635588432e-02,1.06785502659393283e+00,1.33157903524621299e-02,1.08843155586442249e-02,1.28979208054998389e-02,3.99799169851485892e-01,4.07543246927486724e-01,4.54954791825978422e-01,1.14944904021642706e-03,3.58028618805575523e-03,1.20909750784441595e-02,
1.10247596021852701e+00,1.05645863144628316e+00,2.02203801752065156e-02,2.04231304548097188e-02,2.40647081451302244e-02,1.10946942122822811e+00,8.43130685180236428e-03,1.19637203764967684e-02,1.68185954987340180e-02,4.57080718785333878e-02,4.26101599765204786e-01,4.64271567127454099e-01,3.95559962043520508e-01,4.79448376796354821e-03,1.63188572845487587e-02,
1.17861311445464367e+00,1.05625360787505573e+00,1.81704233826296482e-02,2.47848797797123252e-02,2.30817050788402825e-02,1.18168484638231330e+00,1.62957482002052956e-02,8.83048336551497080e-03,1.50944891866554437e-02,4.50805315959011355e-01,9.26914500866181240e-02,4.63551714895547695e-01,1.95692283560391488e-03,4.42509227552420392e-01,2.12164294409439465e-02,
1.23749242688549543e+00,1.05592222868730623e+00,2.00684579355914841e-02,2.51279891375204359e-02,2.53862911395873019e-02,1.23867338345600442e+00,4.95244831254301882e-02,1.84471723798158502e-02,1.84866854753836587e-02,4.75531266484368401e-02,9.32803225970022798e-02,4.81487735512043824e-01,4.78789217469812067e-01,4.84062983940670710e-01,2.84495241588268652e-02,
1.24455754654540773e+00,1.05584220052812827e+00,1.97261484579623961e-02,2.07290095186232065e-02,2.71647438160748551e-02,1.24555658856301554e+00,8.02563817007518332e-02,3.29639482856454447e-02,4.16383776872309430e-02,4.63669953750642017e-01,4.89758033199130249e-01,1.48711453541003125e-01,2.54313551612610472e-03,8.06574695469233424e-03,4.80353497776087601e-01,
1.27430521698144350e+00,1.05550520026475270e+00,1.93585199170744349e-02,2.31946409623157539e-02,2.70469599734466035e-02,1.27417694949949722e+00,4.22648776009763097e-02,2.12058015566530152e-02,4.39750607639945557e-01,4.70190419345634658e-02,5.06521342429281818e-01,1.49414789218645594e-01,5.36437828860248378e-01,1.07666647275617231e-02,5.36066411155240230e-01,
1.28387975713791058e+00,1.05479569176449273e+00,2.14907534445848460e-02,2.45575589816166076e-02,2.59742422748644904e-02,1.28347989019661113e+00,1.91788054437933730e-01,6.75777191806299582e-01,8.16717154071869844e-02,4.75304004588592621e-01,9.47401765929022921e-02,1.50504566116614391e-01,4.34248825675314937e-03,5.30328192807913212e-01,5.74253177992149921e-01,
1.29094388295616169e+00,1.05384351060596515e+00,1.86400730243768617e-02,2.39372691490630611e-02,2.60524138844020307e-02,1.29024065974726421e+00,1.22289296376651591e-01,2.17157609471417323e-01,1.37764414787619693e-01,4.92674964240309779e-02,9.60674979761618753e-02,1.50977709651920200e-01,5.77487687147248963e-01,5.95169675465517134e-01,5.94301621953219783e-01,

