1
1
15
0
(8 0
((0,0,0) (7,7,7) (0,0,0))
((8,0,0) (15,7,7) (0,0,0))
((0,8,0) (7,15,7) (0,0,0))
((8,8,0) (15,15,7) (0,0,0))
((0,0,8) (7,7,15) (0,0,0))
((8,0,8) (15,7,15) (0,0,0))
((0,8,8) (7,15,15) (0,0,0))
((8,8,8) (15,15,15) (0,0,0))
)
8
FabOnDisk: Cell_D_00000 0
FabOnDisk: Cell_D_00000 61527
FabOnDisk: Cell_D_00000 123055
FabOnDisk: Cell_D_00000 184583
FabOnDisk: Cell_D_00000 246112
FabOnDisk: Cell_D_00000 307640
FabOnDisk: Cell_D_00000 369169
FabOnDisk: Cell_D_00000 430698

8,15
1.22524442070025812e-02,1.91896205623256523e-02,-1.40163732508745247e-02,-1.29361023324499457e-02,-7.01675729072885959e-03,6.29057286184057762e-01,-2.13417259927896775e-03,7.00912352964519090e-04,1.87531564544642722e-03,-1.00422246422703365e-02,-3.18389662832923720e-02,-9.53724514722650574e-02,-3.84952766693945403e-01,-4.39389857524678296e-01,-4.93606741717007469e-01,
1.20451999397905504e-02,7.62682500333370424e-03,-9.49066903123541722e-03,-1.28049981062055129e-02,-6.00906734007539654e-03,6.28970263395911555e-01,-9.85264375119394679e-03,-2.61975198388920104e-04,-1.52812578429530922e-02,-3.84772451095656609e-01,-4.04631491756025086e-02,-1.18744955822869314e-01,-7.01155219149479231e-02,-4.68112471163716404e-01,-5.36810104990431469e-01,
1.20785036818980007e-02,3.26320479472631819e-03,-1.40460964752625751e-02,-6.60131792089457478e-03,-6.73632768607240577e-03,6.28669137084554852e-01,-1.46523004506898878e-03,-5.69783937913166325e-03,-3.94249482690592762e-02,-1.59914631146483473e-02,-4.22251968815824275e-01,-1.45347026511722821e-01,-4.83696177309201225e-01,-1.46601564002378226e-01,-5.58639474320960838e-01,
1.20985298599584849e-02,1.28397343972540658e-03,-1.21771866414941109e-02,-8.08470205284691698e-03,-9.27605290895653148e-03,6.28316382891282554e-01,-2.80205980816332495e-02,-5.99583215845012497e-03,-3.30643231282428951e-02,-4.47836906545264590e-01,-4.30403511100641456e-01,-1.78312712547123831e-01,-7.23858178664428392e-02,-1.48533833739162624e-01,-5.62103043141330194e-01,
1.21348491938541320e-02,1.10310336594178862e-03,-1.23355125615633096e-02,-1.12783952207815841e-02,-5.03808368330685777e-03,6.29424748297013337e-01,-5.80509557773054886e-03,-2.04420935446219601e-02,-5.21618130126347539e-03,-2.04040362129481352e-02,-6.46232002937909000e-02,-4.51820057488850124e-01,-5.34618023297830258e-01,-5.59163616672908037e-01,-2.36002663177409699e-01,
1.21597278108531576e-02,-3.74857327311281640e-05,-1.33436207567806820e-02,-1.07833218502275917e-02,-6.63125131314252006e-03,6.27642093179518579e-01,-6.36980964910242586e-02,-6.80979888351647134e-01,-8.94473657278719442e-03,-4.69446565175961616e-01,-8.11182126422336225e-02,-4.74158286269992346e-01,-7.09374578511863529e-02,-6.07167916621665027e-01,-2.36921414500864930e-01,
1.22267804181128217e-02,-4.00670293095249945e-04,-1.24693525422704399e-02,-1.00774436181613192e-02,-6.12409047712846391e-03,6.27187496234163033e-01,-2.82977064924098479e-02,-1.44411123787175286e-02,-9.67043939843854061e-02,-3.18742196170573311e-02,-4.74518059424155203e-01,-4.83701399329406423e-01,-5.60643036953874185e-01,-1.51142643921363701e-01,-2.38134594691631146e-01,
1.22837470981820799e-02,-7.51267149189753340e-04,-1.67122830765952801e-02,-1.37733970144133834e-02,-8.23376540042778000e-03,6.27280514588091087e-01,-4.42772580369217711e-02,-1.67287100549829287e-02,-2.61140918900330393e-02,-4.74555386261776291e-01,-5.05588698347629428e-01,-4.83506138548705666e-01,-7.53787007772078743e-02,-1.52306298610218077e-01,-2.39875400612471923e-01,

8,15
9.77781509214620370e-01,1.05559218172954239e+00,1.56127660712381822e-02,1.87712249165273015e-02,2.32185799841963351e-02,1.06786121919870380e+00,1.32775408168715626e-02,1.05640276604445516e-02,1.27283339941437045e-02,3.96855663922824509e-01,4.09108535614623348e-01,4.55036389315234824e-01,1.12003693200623915e-03,3.62993907066251837e-03,1.25665197576519672e-02,
1.09374894755830065e+00,1.05646604191328231e+00,2.00503507849205953e-02,2.01179838033963901e-02,2.41250728065491964e-02,1.10137577256163444e+00,7.79597244789432750e-03,1.19102508784466390e-02,1.61600315775822546e-02,4.55050557039602260e-02,4.22051557762261109e-01,4.66099500416886081e-01,3.93262120300001350e-01,4.85605851509934676e-03,1.69556227024787350e-02,
1.17460769319075720e+00,1.05625555261054038e+00,1.80116270814819207e-02,2.47909542156604656e-02,2.32307909879488905e-02,1.17787089798548350e+00,1.48407641123913421e-02,8.75327048466820364e-03,1.53784893164581622e-02,4.49743560232252204e-01,9.43370097277459463e-02,4.66243443336130103e-01,1.91927927040126786e-03,4.40176204797189163e-01,2.23196708927434276e-02,
1.23514994452597593e+00,1.05593038046053023e+00,2.00978104272286906e-02,2.51194712587636294e-02,2.55499095661601769e-02,1.23643391796570135e+00,3.83468960144154533e-02,1.21774605581504644e-02,1.84645400672741981e-02,4.72316815896737033e-02,9.47946135954948615e-02,4.78141569891492368e-01,4.75324926459870234e-01,4.81591251825092548e-01,2.99168410603535030e-02,
1.24229279116444613e+00,1.05583829993846345e+00,1.96454049434635625e-02,2.04503535378649931e-02,2.71089865262190005e-02,1.24339589453038801e+00,4.57183270149530696e-02,1.85507226184835790e-02,2.72829501224153281e-02,4.63318371582917998e-01,4.89181097187640579e-01,1.50881911511916572e-01,2.50018119792935712e-03,8.28597135467211941e-03,4.80791587212648919e-01,
1.27203412144449834e+00,1.05550794500149903e+00,1.93459800168509395e-02,2.28841794675608938e-02,2.69649224975842990e-02,1.27199663571176713e+00,3.73002485652929316e-02,2.00459234250482538e-02,1.10493360197210663e-01,4.67517518181161384e-02,5.07054635927832620e-01,1.51659703663405560e-01,5.34633131204418688e-01,1.10528831936292649e-02,5.35536092220696869e-01,
1.28411322149082108e+00,1.05476926323521814e+00,2.12184292161997357e-02,2.45091429153028104e-02,2.58066986787782691e-02,1.28371255119772587e+00,6.68228356365581366e-02,1.32397211668076997e-01,1.04630653885955702e-01,4.75284481861397767e-01,9.66076212965737147e-02,1.52955871008562061e-01,4.30260354857509020e-03,5.32328368449425549e-01,5.73684229355294395e-01,
1.29109835533911488e+00,1.05381087351870351e+00,1.84706988733916132e-02,2.39351328127751367e-02,2.59510849078484554e-02,1.29039049227880009e+00,1.37499725784833077e-01,1.78871071254539271e-01,1.70973639339623062e-01,4.89754500216563610e-02,9.77376860405942127e-02,1.53327140716978116e-01,5.77924814064248449e-01,5.96091886909630997e-01,5.91134170318684760e-01,

