1
1
15
0
(8 0
((0,0,0) (7,7,7) (0,0,0))
((8,0,0) (15,7,7) (0,0,0))
((0,8,0) (7,15,7) (0,0,0))
((8,8,0) (15,15,7) (0,0,0))
((0,0,8) (7,7,15) (0,0,0))
((8,0,8) (15,7,15) (0,0,0))
((0,8,8) (7,15,15) (0,0,0))
((8,8,8) (15,15,15) (0,0,0))
)
8
FabOnDisk: Cell_D_00000 0
FabOnDisk: Cell_D_00000 61527
FabOnDisk: Cell_D_00000 123055
FabOnDisk: Cell_D_00000 184583
FabOnDisk: Cell_D_00000 246112
FabOnDisk: Cell_D_00000 307640
FabOnDisk: Cell_D_00000 369169
FabOnDisk: Cell_D_00000 430698

8,15
1.23912022664053462e-02,6.26732739806660916e-02,-1.58606884224561234e-02,-1.54963069971315991e-02,-1.32585832922532329e-02,6.32837513344217562e-01,-2.84673540440949979e-03,-2.32966702742302186e-03,-1.00125360658389348e-03,-9.54626889295277260e-03,-3.99467774076230145e-02,-1.29423689216757343e-01,-3.43194446993428548e-01,-3.86156987221770054e-01,-4.41767550930656505e-01,
1.21570875780171051e-02,2.73789840451865996e-02,-1.01177400623290691e-02,-1.58222954819208783e-02,-1.27231795174939898e-02,6.35183477240435446e-01,-7.66585937954579379e-03,-2.09792166082901563e-03,-1.56989002334146483e-03,-3.58770853443044546e-01,-5.29971699884598801e-02,-1.65902657908260809e-01,-9.05480335778334755e-02,-4.46917187740030752e-01,-4.93438098673290582e-01,
1.21625298670977825e-02,8.72003828751843381e-03,-1.36326515279558916e-02,-1.08997367739086005e-02,-1.20312848291516013e-02,6.28280719979552371e-01,-2.49146770789311287e-03,-1.07515529553705667e-02,-2.42265955759085952e-02,-1.72340200729346367e-02,-3.96333298530773315e-01,-2.12772282320091100e-01,-4.24103325979678480e-01,-1.85245881381897903e-01,-5.63470293442680958e-01,
1.21934790714790520e-02,2.84689005013499287e-03,-1.61730614494602944e-02,-1.50158897226376938e-02,-1.35534556295105850e-02,6.28070294763073078e-01,-1.48003359383871436e-02,-1.26585503415775659e-02,-4.72198662571661210e-02,-4.29040778851635385e-01,-4.03137112448684665e-01,-2.64872798671349940e-01,-9.03703533564693684e-02,-1.86357108227556412e-01,-6.03055113288423539e-01,
1.21902237654189192e-02,2.16307246641665599e-03,-1.42575508198270126e-02,-1.57572498977595066e-02,-1.29843253587321270e-02,6.28370247909089574e-01,-2.99645335861423254e-03,-3.08012822571549008e-02,-6.14568100438918526e-03,-2.38665585681995425e-02,-9.78780698196546339e-02,-4.36070088951088786e-01,-5.10957325059545830e-01,-5.17269835910771469e-01,-2.83018580375248574e-01,
1.22204999805186759e-02,4.34131999561699613e-04,-1.46096515713199700e-02,-1.48664458143933937e-02,-1.22380550223417147e-02,6.29285239241908823e-01,-7.56606308393984878e-02,-1.17484654429329594e-01,-2.15501699978991358e-02,-4.59195552356104764e-01,-1.27167580569419375e-01,-4.48588454726239427e-01,-9.14379799494309947e-02,-5.93915101915504673e-01,-2.87849765969188320e-01,
1.23223344623795139e-02,-4.36095327124227830e-04,-1.49356664920808173e-02,-1.17880259914222921e-02,-1.12964498663402340e-02,6.29476570307186623e-01,-1.01732208630560050e+00,-4.16944742689666581e-01,-1.83587978343929648e-01,-4.19666727454098970e-02,-4.86267891158658982e-01,-4.48414424974955150e-01,-5.80448449635740271e-01,-1.91226990634181138e-01,-2.87115259556250946e-01,
1.24254965932855208e-02,-8.07389520083227506e-04,-1.70176332245357553e-02,-1.24724708763156687e-02,-1.47396261220755168e-02,6.29339368721398396e-01,-5.27919873048469213e-01,-2.35216363354921743e-02,-1.19262777778367801e+00,-4.76011259775231566e-01,-5.03872364776824178e-01,-4.96374175045377619e-01,-9.28238244026594606e-02,-1.93383525232115716e-01,-2.88015359284550909e-01,

8,15
7.64219321298529097e-01,1.05500426910056788e+00,1.27065334554859882e-02,1.56088235159338850e-02,1.59672781490709480e-02,1.06739547136697333e+00,9.05257036679532959e-03,1.10367673619142237e-02,9.21030416376199604e-03,3.66970754728802140e-01,4.02940191045975615e-01,4.18770481288029073e-01,1.05845987618944423e-03,4.60354576895452127e-03,1.98064591854983929e-02,
9.25425111745765472e-01,1.05601749994247851e+00,1.85966882153331542e-02,1.81522752269218310e-02,1.98757502640086042e-02,1.06818564858564313e+00,4.95320709113329562e-03,1.48818281477096966e-02,9.52597019277997073e-03,5.77582361723305432e-02,4.27130205365754023e-01,4.58907523825926811e-01,3.39564621517108922e-01,6.48351348197483655e-03,2.84879799748835039e-02,
1.07876848277053927e+00,1.05601246338140564e+00,1.84190148214262647e-02,1.96040533505796796e-02,1.75695454823330821e-02,1.08748852105805760e+00,1.73734030092180421e-02,1.14456710822183998e-02,1.29434441585785705e-02,4.24093558901271761e-01,1.20100145575461406e-01,4.87403871414885004e-01,2.03655637063200135e-03,3.95160589309192511e-01,4.14277392306261136e-02,
1.18437872758507923e+00,1.05562306949373563e+00,1.66549469501726666e-02,1.99299458179826791e-02,2.04358751812607764e-02,1.18722561763521428e+00,2.00569386259878239e-02,1.21277632571800652e-02,1.29337897032820708e-02,5.86226369697404395e-02,1.20729296164201430e-01,4.95401352643574433e-01,4.35344940042140083e-01,4.41269644359070679e-01,5.90154597763533142e-02,
1.20608432824131562e+00,1.05579298448556491e+00,1.73618206902111036e-02,1.56311966896514540e-02,2.10589999377134296e-02,1.20824740070773218e+00,1.87084731126289650e-02,1.30557004905384778e-02,1.12691058113242905e-02,4.62700625446710367e-01,4.64349580918132498e-01,1.82006682847576845e-01,2.89451056642128432e-03,1.33634873818496980e-02,4.60007944019752923e-01,
1.25890496009932962e+00,1.05538117620229110e+00,1.69834684499728106e-02,1.64268465746216646e-02,2.03267065803106606e-02,1.25933909209889139e+00,9.07755769877374719e-02,1.20595295240540946e-02,4.25981142608392871e-02,5.89484877960526760e-02,5.04925247975504754e-01,1.82057121094210822e-01,5.14851046038171223e-01,1.89149436480833058e-02,5.11589559713856556e-01,
1.28220674245750388e+00,1.05446771064980149e+00,1.88304029627337152e-02,2.01691766987698758e-02,2.06273107822941837e-02,1.28177064713037958e+00,5.29728527483106018e-02,4.08199710596319765e-02,1.18546374603981097e+00,4.76623827613958995e-01,1.22217536889553863e-01,1.82203426112347966e-01,5.66650017691000280e-03,5.55790902336215642e-01,5.37692791039198426e-01,
1.29131985565238661e+00,1.05284902651473411e+00,1.82931369692005616e-02,1.93499974737182251e-02,2.09130978255599037e-02,1.29051246613230330e+00,3.84510004296021446e-01,2.48766407952085711e+00,8.23858359409396668e-01,5.93616747732920030e-02,1.23015896999853658e-01,1.83509361850675567e-01,5.61940940471790884e-01,6.08241472608263334e-01,5.78674255854591979e-01,

