1
1
15
0
(8 0
((0,0,0) (7,7,7) (0,0,0))
((8,0,0) (15,7,7) (0,0,0))
((0,8,0) (7,15,7) (0,0,0))
((8,8,0) (15,15,7) (0,0,0))
((0,0,8) (7,7,15) (0,0,0))
((8,0,8) (15,7,15) (0,0,0))
((0,8,8) (7,15,15) (0,0,0))
((8,8,8) (15,15,15) (0,0,0))
)
8
FabOnDisk: Cell_D_00000 0
FabOnDisk: Cell_D_00000 61527
FabOnDisk: Cell_D_00000 123055
FabOnDisk: Cell_D_00000 184583
FabOnDisk: Cell_D_00000 246112
FabOnDisk: Cell_D_00000 307640
FabOnDisk: Cell_D_00000 369169
FabOnDisk: Cell_D_00000 430698

8,15
1.08733040236410998e-02,3.06931798871373134e-03,-1.86104437466176054e-02,-1.34337094236038866e-02,-9.95154333077402989e-03,6.26681280265778962e-01,-8.46709237155689144e-04,-7.74326564710677099e-03,-1.62524701641912558e-02,-1.05349731894974936e-02,-2.65011035410913642e-02,-5.06562902574607260e-02,-4.83669313821950220e-01,-4.98319003352447609e-01,-5.04935670277444015e-01,
1.07292216639908004e-02,1.40841602357958794e-03,-5.91943175502383009e-03,-1.24322631524750506e-02,-9.09382185656461284e-03,6.26671270907266154e-01,-3.31030398785647356e-02,-9.78881428326597303e-03,-1.23277191404250856e-02,-4.38529041731802682e-01,-3.18810946338362183e-02,-6.04736476514457083e-02,-3.74685750360719619e-02,-5.35939690552367454e-01,-5.52900709918266342e-01,
1.08220786292543229e-02,9.88264890801333288e-04,-1.93050394408523091e-02,-2.97464843796882948e-04,-7.24400933517613602e-03,6.29273601394564341e-01,-2.45995942035435490e-03,-6.87048111579572924e-03,-2.04379632123439167e-02,-1.40761914170938005e-02,-4.52584015987588351e-01,-6.56542494957236267e-02,-5.19306205386953046e-01,-8.96045835603445362e-02,-5.72418838379505246e-01,
1.08118021880524353e-02,3.24212646404158301e-05,-6.82693412924153219e-03,-1.66083814933917513e-03,-8.05179861689591693e-03,6.27919033498217982e-01,-5.15611545502766555e-02,-4.64177609748580910e-01,-2.55413527402134877e+00,-4.70261615514992404e-01,-4.57733140588926724e-01,-7.82512952383652705e-02,-4.30844991848346806e-02,-9.16845288247705448e-02,-6.06011677260834269e-01,
1.08969495383972655e-02,3.04946021171295081e-04,-1.90841065565980905e-02,-1.21808466854500808e-02,4.35335252928773647e-04,6.27918097578969436e-01,-7.08665600727245194e-03,-9.55877997499068599e-02,-6.81706917855788228e-03,-1.57776018737199389e-02,-3.93300930651350536e-02,-4.33382090733053116e-01,-5.25541828177035097e-01,-5.67537280981625591e-01,-1.41642006657619862e-01,
1.08753879020563726e-02,-2.00579807701248649e-04,-4.08806211970384140e-03,-1.43153115235085237e-02,-1.36438703554794512e-04,6.29514247801005400e-01,-1.94528310170998184e-02,-3.20689157654523438e-01,-1.93504838905679044e-01,-4.79922688676920395e-01,-4.71348404431373297e-02,-4.66258665276531925e-01,-4.23241397678646505e-02,-5.74027179774698970e-01,-1.41512463376951392e-01,
1.10400046696796528e-02,-2.29906258887943327e-04,-1.68471417307368039e-02,-1.71177165832525797e-03,-1.15916731662144565e-03,6.28112056599155810e-01,-2.45318013874183949e-01,-1.23389217577951280e-02,-1.27576719068536390e-02,-2.10566470239229586e-02,-4.57293841679652147e-01,-4.81476940962822453e-01,-5.79105900686444297e-01,-9.13402220383502383e-02,-1.43111521821877308e-01,
1.09468475375984094e-02,-6.27065630551013422e-04,-8.91377906698719198e-03,-6.67960952207801405e-03,-1.53338522041081651e-03,6.24748556016107348e-01,-9.30360201798403202e-03,-2.66495520324845671e-02,-1.36102574820657352e-02,-4.85076725870795866e-01,-4.81685219250071239e-01,-5.06893765946689445e-01,-4.69545626998975618e-02,-9.72688253468005498e-02,-1.43302648266679017e-01,

8,15
1.18530435517067145e+00,1.06161087328551940e+00,1.66667252515191530e-02,2.14938757885874965e-02,2.75568836994400934e-02,1.18837367315938525e+00,2.31024629900856114e-02,1.49616382004269140e-02,1.98138639303289503e-02,4.41673729689569694e-01,4.60924679724249942e-01,4.69282928129851507e-01,1.24305268126466677e-03,3.15083021677890979e-03,6.12721615212655918e-03,
1.22833092546058720e+00,1.06250414642372504e+00,2.67194272475069459e-02,2.14590361723786573e-02,2.73370994318747756e-02,1.22973934148416686e+00,2.24993970829357876e-02,1.67778364151154324e-02,2.04268688034342158e-02,2.40890877612893392e-02,4.72955391514793710e-01,4.91738711306438536e-01,4.54425904878884457e-01,3.96133020083367336e-03,7.65268436707476456e-03,
1.24382695398112819e+00,1.06096285530273482e+00,1.68036292038092894e-02,3.15232624654538038e-02,2.79509054667508583e-02,1.24481521887192947e+00,6.32098882015216523e-02,1.52137520142305444e-02,2.07602910250029166e-02,4.41700841903244878e-01,5.73747965865746279e-02,4.98723196723335871e-01,1.75934832811950074e-03,5.00928833979353616e-01,8.36962081702964655e-03,
1.26432158310676090e+00,1.06195377351822140e+00,2.89394201225423621e-02,3.21671743927856163e-02,3.04436649570203680e-02,1.26435400437140122e+00,6.92112205204046704e-01,2.36081201858394457e-01,2.46678143507915171e-02,2.85272193840128488e-02,6.08945718689590798e-02,5.09826859711290270e-01,5.26344165296321997e-01,5.31651644289665271e-01,1.04295620619736171e-02,
1.26132661553070857e+00,1.06047565109269604e+00,1.66675072012395717e-02,2.11477629592937907e-02,4.00854725748222007e-02,1.26163156155187983e+00,5.28771998119772352e-02,3.01729945842462675e-02,7.10000225775777316e-02,4.52838269995506026e-01,4.75970797135938872e-01,9.15392478934713150e-02,2.00290875815219496e-03,5.02420837730979588e-03,5.08419711641374450e-01,
1.27240655486086496e+00,1.06147802802418800e+00,2.90282828365251953e-02,2.31962237614519173e-02,4.00971753636778921e-02,1.27220597505316380e+00,2.88904663846459353e-01,2.80254547690638178e-02,2.38643256308121748e-01,2.72482798089248857e-02,4.74968517504040677e-01,9.01954190013872226e-02,5.55906457352233874e-01,6.29581602964576943e-03,5.13522536726970680e-01,
1.27630200908231961e+00,1.05933212259831744e+00,1.70429526459342680e-02,3.45092846455357649e-02,4.08600412895429935e-02,1.27611960049022266e+00,4.36659653753685290e-02,1.23767033608006205e+00,9.24683320976191991e-01,4.96914556368270977e-01,5.96955819145825878e-02,9.21839121916256110e-02,2.84078494905956819e-03,5.50997691780392929e-01,5.41815664745581849e-01,
1.28109911048927505e+00,1.06030762841632176e+00,2.64408194205950978e-02,3.37725187008101196e-02,4.05869137712640896e-02,1.28047204485872412e+00,5.50114902237292758e-01,4.04448098650762811e-01,2.09321385182562575e-01,3.07697182000836733e-02,6.39159099422564880e-02,9.31671105918629172e-02,5.90995276989110252e-01,5.55033117822817723e-01,5.93248273881241128e-01,

