1
1
15
0
(8 0
((0,0,0) (7,7,7) (0,0,0))
((8,0,0) (15,7,7) (0,0,0))
((0,8,0) (7,15,7) (0,0,0))
((8,8,0) (15,15,7) (0,0,0))
((0,0,8) (7,7,15) (0,0,0))
((8,0,8) (15,7,15) (0,0,0))
((0,8,8) (7,15,15) (0,0,0))
((8,8,8) (15,15,15) (0,0,0))
)
8
FabOnDisk: Cell_D_00000 0
FabOnDisk: Cell_D_00000 61527
FabOnDisk: Cell_D_00000 123055
FabOnDisk: Cell_D_00000 184583
FabOnDisk: Cell_D_00000 246112
FabOnDisk: Cell_D_00000 307640
FabOnDisk: Cell_D_00000 369169
FabOnDisk: Cell_D_00000 430698

8,15
1.09531132019317235e-02,3.52273074377809506e-03,-1.78694336566078971e-02,-1.30559957142829287e-02,-8.26532837638456995e-03,6.26096519537935547e-01,-1.54633735725803897e-03,-8.10673016616645509e-03,-1.69824856568030827e-02,-1.08970062699343950e-02,-2.58106018181241854e-02,-5.43537210774810778e-02,-4.76861757142943543e-01,-4.89507278833914539e-01,-4.93431243298482314e-01,
1.08053469053732611e-02,1.62939995179731947e-03,-5.86195725614637678e-03,-1.09999317552198599e-02,-7.81739098085003359e-03,6.27124272168271935e-01,-2.59256574988169057e-02,-6.24985962334198911e-03,-9.85774671845732198e-03,-4.35873528941172039e-01,-3.12537321987916422e-02,-6.50958249004069400e-02,-4.27293664346411611e-02,-5.30746469246272223e-01,-5.46464184341804771e-01,
1.09018975914639497e-02,1.19576447076886355e-03,-1.78434748043212466e-02,-5.22459942199422940e-04,-5.49362791184299613e-03,6.27965431217267334e-01,-2.01994505065452527e-03,-8.28083452478039009e-03,-1.60291609768387494e-02,-1.45246538598517438e-02,-4.50103775194784284e-01,-7.17563719637187847e-02,-5.17421758919117458e-01,-9.06328951406654149e-02,-5.67089194877097968e-01,
1.08768266466601014e-02,1.82128047571633199e-04,-7.65635406984470964e-03,-1.17998789035891373e-03,-7.67240750293988420e-03,6.27376949173784837e-01,-4.11303338674334634e-02,-7.34171418164413780e-02,-4.06733626945584015e-01,-4.67797754053924486e-01,-4.56896612371787747e-01,-8.56974246345907631e-02,-4.65876959144320840e-02,-9.16718846820683414e-02,-6.07010594515863700e-01,
1.09870052591644774e-02,3.24093148717752375e-04,-1.77578957102723783e-02,-1.05139126074512389e-02,2.07803099654871488e-04,6.28202497896821921e-01,-7.79744999426629833e-03,-5.97065114662070628e-02,1.35595760033743913e-03,-1.67804462258122414e-02,-4.01142372454080243e-02,-4.38522285081901775e-01,-5.27473766250249776e-01,-5.68876408847766135e-01,-1.52170849570922695e-01,
1.09449227883803239e-02,-2.30394489365492902e-04,-4.09807700606685133e-03,-1.51719297898808211e-02,-6.42015396166998253e-05,6.29641510840983853e-01,-5.03237161867699956e-01,-1.84698035445737530e+00,-2.53301132853731681e-01,-4.79267866238761830e-01,-4.83281923576227707e-02,-4.70786183588105200e-01,-4.52179608702072966e-02,-5.76296370040424444e-01,-1.50817397393104013e-01,
1.11148063355497751e-02,-2.59858354613023426e-04,-1.58570408184973630e-02,-2.35762031513371637e-03,-1.04559040475008446e-03,6.27581632612010609e-01,-6.25945732677001665e+00,-8.86977812866593385e-03,-1.27986434235955425e-02,-2.23344463965867886e-02,-4.55712716792707639e-01,-4.86591691773029078e-01,-5.78448251030618144e-01,-9.58051873633601059e-02,-1.55886987789635084e-01,
1.10258339637748851e-02,-6.92113532089236555e-04,-9.36915269418176280e-03,-6.95046040400870181e-03,-1.27191766857208464e-03,6.24830255740573826e-01,-1.40811232614518195e-02,-5.45364746030706504e-02,-1.53344367831286365e-02,-4.83455729127114042e-01,-4.82956026899926449e-01,-5.09893781411032698e-01,-5.03272487953625863e-02,-9.88639770916148464e-02,-1.55891307668224455e-01,

8,15
1.17409475454708012e+00,1.06113891605552579e+00,1.67353959714648670e-02,2.16625094642108953e-02,2.81250890555212255e-02,1.17761748529085830e+00,1.96899429264378450e-02,1.63958106978442791e-02,2.09215869354601111e-02,4.40569354621497156e-01,4.57727021229058728e-01,4.62869206051144788e-01,1.26360324632905229e-03,3.01974662012893368e-03,6.62601309760740137e-03,
1.22332284318428441e+00,1.06205973345753746e+00,2.60955010051617045e-02,2.17294426850881892e-02,2.79738932803010251e-02,1.22495224313608175e+00,2.13947952945551106e-02,1.94361336586972647e-02,2.14710348273372785e-02,2.82037354506023304e-02,4.72228433190837515e-01,4.89446966777103865e-01,4.49325698578927901e-01,3.83102141746487646e-03,8.31854738474198559e-03,
1.23950629253131606e+00,1.06057671185154700e+00,1.69874934886500711e-02,3.07525678715634895e-02,2.89610234655754348e-02,1.24070205700208502e+00,5.51456726890022092e-02,1.35973399954917255e-02,2.20746507924107563e-02,4.43523716166099480e-01,5.93006106798773663e-02,4.97777957468316434e-01,1.79964700817426154e-03,4.93532198341934736e-01,9.25747725135618073e-03,
1.26313636550026231e+00,1.06157989532464803e+00,2.82050621453171883e-02,3.10119187121422300e-02,3.01225164155078939e-02,1.26331849354783388e+00,1.38773811134234620e-01,1.09685575392111129e-01,2.59968441595590169e-02,3.13658821625153253e-02,6.06982262639983172e-02,5.13283309582776348e-01,5.21071745563631339e-01,5.26869188189473259e-01,1.15745992552962369e-02,
1.26185757458870085e+00,1.05992505306425144e+00,1.68310154702749140e-02,2.14504226763814303e-02,3.97675466352054932e-02,1.26218166773741869e+00,5.66038805268354039e-02,4.52872399137778936e-02,8.94341934112774101e-02,4.49600100515992196e-01,4.77337372914295621e-01,9.78732928403397012e-02,2.11131000411822218e-03,5.09085013953327649e-03,5.03430174753150550e-01,
1.27369907819117989e+00,1.06097300093553693e+00,2.86543012835320937e-02,2.44155096757106560e-02,4.04427338966545716e-02,1.27346868370181432e+00,3.05397959921191009e-01,5.26582076171796115e-02,4.40068663008714722e-01,2.95858826644239195e-02,4.76081659567275772e-01,9.61443520302990295e-02,5.56704062889291196e-01,6.42924061947115072e-03,5.20561609969059980e-01,
1.27786094790126792e+00,1.05874361409552464e+00,1.77664703507232832e-02,3.32514612787728273e-02,4.09939867633680732e-02,1.27764329259110476e+00,5.24370925492134987e-02,4.27017225753883736e+01,3.42415731384361379e+01,4.96201820100220126e-01,6.26963932698834797e-02,1.01062179499360638e-01,3.00914916155154300e-03,5.50467489943747057e-01,5.50789214227279222e-01,
1.28296769956444723e+00,1.05974924175494878e+00,2.61656182664395387e-02,3.25912093307507977e-02,4.09603859358433769e-02,1.28227558603235803e+00,1.03219680747798681e+00,1.21065903874795389e+00,1.12696131904553964e+00,3.29175558017477943e-02,6.55242644272155395e-02,1.00634606453604614e-01,5.89458041918485387e-01,5.57471051434590525e-01,6.00153486683835502e-01,

