1
1
15
0
(8 0
((0,0,0) (7,7,7) (0,0,0))
((8,0,0) (15,7,7) (0,0,0))
((0,8,0) (7,15,7) (0,0,0))
((8,8,0) (15,15,7) (0,0,0))
((0,0,8) (7,7,15) (0,0,0))
((8,0,8) (15,7,15) (0,0,0))
((0,8,8) (7,15,15) (0,0,0))
((8,8,8) (15,15,15) (0,0,0))
)
8
FabOnDisk: Cell_D_00000 0
FabOnDisk: Cell_D_00000 61527
FabOnDisk: Cell_D_00000 123055
FabOnDisk: Cell_D_00000 184583
FabOnDisk: Cell_D_00000 246112
FabOnDisk: Cell_D_00000 307640
FabOnDisk: Cell_D_00000 369169
FabOnDisk: Cell_D_00000 430698

8,15
1.0953113201931724e-02,3.5227307437780951e-03,-1.7869433656607897e-02,-1.3055995714282929e-02,-8.2653283763845699e-03,6.2609651953793555e-01,-1.5463373572580390e-03,-8.1067301661664551e-03,-1.6982485656803083e-02,-1.0897006269934395e-02,-2.5810601818124185e-02,-5.4353721077481078e-02,-4.7686175714294354e-01,-4.8950727883391454e-01,-4.9343124329848231e-01,
1.0805346905373261e-02,1.6293999517973195e-03,-5.8619572561463768e-03,-1.0999931755219860e-02,-7.8173909808500336e-03,6.2712427216827193e-01,-2.5925657498816906e-02,-6.2498596233419891e-03,-9.8577467184573220e-03,-4.3587352894117204e-01,-3.1253732198791642e-02,-6.5095824900406940e-02,-4.2729366434641161e-02,-5.3074646924627222e-01,-5.4646418434180477e-01,
1.0901897591463950e-02,1.1957644707688635e-03,-1.7843474804321247e-02,-5.2245994219942294e-04,-5.4936279118429961e-03,6.2796543121726733e-01,-2.0199450506545253e-03,-8.2808345247803901e-03,-1.6029160976838749e-02,-1.4524653859851744e-02,-4.5010377519478428e-01,-7.1756371963718785e-02,-5.1742175891911746e-01,-9.0632895140665415e-02,-5.6708919487709797e-01,
1.0876826646660101e-02,1.8212804757163320e-04,-7.6563540698447096e-03,-1.1799878903589137e-03,-7.6724075029398842e-03,6.2737694917378484e-01,-4.1130333867433463e-02,-7.3417141816441378e-02,-4.0673362694558401e-01,-4.6779775405392449e-01,-4.5689661237178775e-01,-8.5697424634590763e-02,-4.6587695914432084e-02,-9.1671884682068341e-02,-6.0701059451586370e-01,
1.0987005259164477e-02,3.2409314871775238e-04,-1.7757895710272378e-02,-1.0513912607451239e-02,2.0780309965487149e-04,6.2820249789682192e-01,-7.7974499942662983e-03,-5.9706511466207063e-02,1.3559576003374391e-03,-1.6780446225812241e-02,-4.0114237245408024e-02,-4.3852228508190177e-01,-5.2747376625024978e-01,-5.6887640884776614e-01,-1.5217084957092269e-01,
1.0944922788380324e-02,-2.3039448936549290e-04,-4.0980770060668513e-03,-1.5171929789880821e-02,-6.4201539616699825e-05,6.2964151084098385e-01,-5.0323716186769996e-01,-1.8469803544573753e+00,-2.5330113285373168e-01,-4.7926786623876183e-01,-4.8328192357622771e-02,-4.7078618358810520e-01,-4.5217960870207297e-02,-5.7629637004042444e-01,-1.5081739739310401e-01,
1.1114806335549775e-02,-2.5985835461302343e-04,-1.5857040818497363e-02,-2.3576203151337164e-03,-1.0455904047500845e-03,6.2758163261201061e-01,-6.2594573267700166e+00,-8.8697781286659338e-03,-1.2798643423595542e-02,-2.2334446396586789e-02,-4.5571271679270764e-01,-4.8659169177302908e-01,-5.7844825103061814e-01,-9.5805187363360106e-02,-1.5588698778963508e-01,
1.1025833963774885e-02,-6.9211353208923655e-04,-9.3691526941817628e-03,-6.9504604040087018e-03,-1.2719176685720846e-03,6.2483025574057383e-01,-1.4081123261451819e-02,-5.4536474603070650e-02,-1.5334436783128636e-02,-4.8345572912711404e-01,-4.8295602689992645e-01,-5.0989378141103270e-01,-5.0327248795362586e-02,-9.8863977091614846e-02,-1.5589130766822445e-01,

8,15
1.1740947545470801e+00,1.0611389160555258e+00,1.6735395971464867e-02,2.1662509464210895e-02,2.8125089055521225e-02,1.1776174852908583e+00,1.9689942926437845e-02,1.6395810697844279e-02,2.0921586935460111e-02,4.4056935462149716e-01,4.5772702122905873e-01,4.6286920605114479e-01,1.2636032463290523e-03,3.0197466201289337e-03,6.6260130976074014e-03,
1.2233228431842844e+00,1.0620597334575375e+00,2.6095501005161705e-02,2.1729442685088189e-02,2.7973893280301025e-02,1.2249522431360818e+00,2.1394795294555111e-02,1.9436133658697265e-02,2.1471034827337278e-02,2.8203735450602330e-02,4.7222843319083752e-01,4.8944696677710386e-01,4.4932569857892790e-01,3.8310214174648765e-03,8.3185473847419856e-03,
1.2395062925313161e+00,1.0605767118515470e+00,1.6987493488650071e-02,3.0752567871563490e-02,2.8961023465575435e-02,1.2407020570020850e+00,5.5145672689002209e-02,1.3597339995491725e-02,2.2074650792410756e-02,4.4352371616609948e-01,5.9300610679877366e-02,4.9777795746831643e-01,1.7996470081742615e-03,4.9353219834193474e-01,9.2574772513561807e-03,
1.2631363655002623e+00,1.0615798953246480e+00,2.8205062145317188e-02,3.1011918712142230e-02,3.0122516415507894e-02,1.2633184935478339e+00,1.3877381113423462e-01,1.0968557539211113e-01,2.5996844159559017e-02,3.1365882162515325e-02,6.0698226263998317e-02,5.1328330958277635e-01,5.2107174556363134e-01,5.2686918818947326e-01,1.1574599255296237e-02,
1.2618575745887008e+00,1.0599250530642514e+00,1.6831015470274914e-02,2.1450422676381430e-02,3.9767546635205493e-02,1.2621816677374187e+00,5.6603880526835404e-02,4.5287239913777894e-02,8.9434193411277410e-02,4.4960010051599220e-01,4.7733737291429562e-01,9.7873292840339701e-02,2.1113100041182222e-03,5.0908501395332765e-03,5.0343017475315055e-01,
1.2736990781911799e+00,1.0609730009355369e+00,2.8654301283532094e-02,2.4415509675710656e-02,4.0442733896654572e-02,1.2734686837018143e+00,3.0539795992119101e-01,5.2658207617179612e-02,4.4006866300871472e-01,2.9585882664423920e-02,4.7608165956727577e-01,9.6144352030299030e-02,5.5670406288929120e-01,6.4292406194711507e-03,5.2056160996905998e-01,
1.2778609479012679e+00,1.0587436140955246e+00,1.7766470350723283e-02,3.3251461278772827e-02,4.0993986763368073e-02,1.2776432925911048e+00,5.2437092549213499e-02,4.2701722575388374e+01,3.4241573138436138e+01,4.9620182010022013e-01,6.2696393269883480e-02,1.0106217949936064e-01,3.0091491615515430e-03,5.5046748994374706e-01,5.5078921422727922e-01,
1.2829676995644472e+00,1.0597492417549488e+00,2.6165618266439539e-02,3.2591209330750798e-02,4.0960385935843377e-02,1.2822755860323580e+00,1.0321968074779868e+00,1.2106590387479539e+00,1.1269613190455396e+00,3.2917555801747794e-02,6.5524264427215539e-02,1.0063460645360461e-01,5.8945804191848539e-01,5.5747105143459053e-01,6.0015348668383550e-01,

