1
1
15
0
(8 0
((0,0,0) (7,7,7) (0,0,0))
((8,0,0) (15,7,7) (0,0,0))
((0,8,0) (7,15,7) (0,0,0))
((8,8,0) (15,15,7) (0,0,0))
((0,0,8) (7,7,15) (0,0,0))
((8,0,8) (15,7,15) (0,0,0))
((0,8,8) (7,15,15) (0,0,0))
((8,8,8) (15,15,15) (0,0,0))
)
8
FabOnDisk: Cell_D_00000 0
FabOnDisk: Cell_D_00000 61527
FabOnDisk: Cell_D_00000 123055
FabOnDisk: Cell_D_00000 184583
FabOnDisk: Cell_D_00000 246112
FabOnDisk: Cell_D_00000 307640
FabOnDisk: Cell_D_00000 369169
FabOnDisk: Cell_D_00000 430698

8,15
1.09886565197317952e-02,3.41734239799757009e-03,-1.77632458502360105e-02,-1.32332839074430306e-02,-8.41251779941246461e-03,6.26170688913711082e-01,-1.38161962336017376e-03,-5.97657796377698905e-03,-1.65514409873565929e-02,-1.09720632885207756e-02,-2.53647370092327136e-02,-5.29602882413853226e-02,-4.78704401521890754e-01,-4.91540217380857458e-01,-4.96484464430740069e-01,
1.08408514583167165e-02,1.58389509917287704e-03,-5.69947731492765567e-03,-1.06259018631391575e-02,-7.41219123946614336e-03,6.27162359002598868e-01,-2.73109916890268700e-02,-8.84543273997488375e-03,-1.03073818378474815e-02,-4.36601083944995916e-01,-3.08057470933445661e-02,-6.37068289850680480e-02,-4.15363294749175119e-02,-5.31515114482849382e-01,-5.48348628715808362e-01,
1.09145893335870960e-02,1.16138054873653478e-03,-1.75575602622252830e-02,-9.40439881134704642e-04,-5.32879661771352119e-03,6.28163247073527664e-01,-2.41749497472393444e-03,-8.60199963472010713e-03,-1.68472229582147422e-02,-1.46733678381244688e-02,-4.50723695981004202e-01,-6.88238848631557432e-02,-5.17872395456250856e-01,-8.91019036316041679e-02,-5.68197168693969301e-01,
1.09078384503604655e-02,1.56656472537637978e-04,-7.23775575462364852e-03,-1.30806426768508965e-03,-7.95442869382944999e-03,6.27569327241574326e-01,-4.47157807011643246e-02,-6.74336543276106148e-02,-4.85420677583207283e-01,-4.68037992506889877e-01,-4.57525985050218909e-01,-8.24026754918332771e-02,-4.76435767871831728e-02,-9.13083779656385791e-02,-6.07143321575650541e-01,
1.10233043223384522e-02,3.22862578190728734e-04,-1.82020662613747546e-02,-1.10287620467098679e-02,3.64900544018446210e-04,6.28151496258813280e-01,-7.92184018167083580e-03,-6.62670891184493349e-02,1.42565349589842110e-03,-1.68194958068560059e-02,-3.91588834623372573e-02,-4.37261296882123784e-01,-5.27258221531038851e-01,-5.67413841734294211e-01,-1.49616311152083376e-01,
1.09753868509838183e-02,-2.08914212691577958e-04,-4.46075259010846048e-03,-1.58774933797055720e-02,-7.79893092639030218e-05,6.29948460172045532e-01,-2.05154109286888806e-02,-2.08852413515113300e-01,-1.27502750901481887e-01,-4.79235997364744093e-01,-4.73251947665316308e-02,-4.70361457090257229e-01,-4.68307127698944572e-02,-5.73899872900091257e-01,-1.50265560822642752e-01,
1.11377451676074948e-02,-2.40883677637834169e-04,-1.58303044777457907e-02,-3.18990038496203693e-03,-1.09768296407255811e-03,6.27783628424352314e-01,-7.97765872041265589e-01,-8.62267523349680674e-03,-1.22461138697663053e-02,-2.24759310039583729e-02,-4.56623726370721017e-01,-4.84448178006475660e-01,-5.77571304544590713e-01,-9.26375595725284634e-02,-1.52342355545165731e-01,
1.10495534017960653e-02,-6.57123755427110531e-04,-9.58982011037761914e-03,-6.77051084109505860e-03,-1.35603061136718630e-03,6.25195256403499933e-01,-1.43947553479759887e-02,-5.51499092822945597e-02,-1.48986661679669386e-02,-4.83011762808949197e-01,-4.81545369292212977e-01,-5.09093198514777745e-01,-5.19112711797756268e-02,-9.77603050563756321e-02,-1.53718234853725128e-01,

8,15
1.17715095531079950e+00,1.06101703322936891e+00,1.68157188868752992e-02,2.16415440452736758e-02,2.82357825298150573e-02,1.18056829770879701e+00,1.94100843350754962e-02,1.68525742898419754e-02,2.10532093219939348e-02,4.40791040732792239e-01,4.58135029595486076e-01,4.64471522365757172e-01,1.28080189438976367e-03,2.99291555183375801e-03,6.37686505584949409e-03,
1.22452414527808595e+00,1.06201788892500315e+00,2.58614339456387163e-02,2.17899735279146189e-02,2.82135148589039153e-02,1.22610804037725885e+00,2.11867945994430630e-02,1.98405717323293547e-02,2.15996130938450846e-02,2.75730583681882482e-02,4.71629170164802547e-01,4.90205132265038701e-01,4.51079642397318570e-01,3.80972156019480793e-03,8.04149700652953894e-03,
1.24022861410252383e+00,1.06041212601171986e+00,1.70828381641643760e-02,3.05476552060309804e-02,2.81432283244855037e-02,1.24138999465126032e+00,5.59709461945612358e-02,1.33049485078021723e-02,2.19481953022200478e-02,4.42991529883216439e-01,5.75877947038416840e-02,4.98050747150334927e-01,1.83791048845598822e-03,4.94568500843429182e-01,8.78296812478952110e-03,
1.26331065881343285e+00,1.06148654611249671e+00,2.78265348095193613e-02,3.05786033474793884e-02,2.86185953417914633e-02,1.26346731528597056e+00,1.52118761868519498e-01,1.25798013596110703e-01,2.59853391563627592e-02,3.22019296898011093e-02,6.06338028952105451e-02,5.12842116541571302e-01,5.22138698402142776e-01,5.27957916279737871e-01,1.10032061681243909e-02,
1.26191432372127554e+00,1.05985579900161886e+00,1.67749353312720874e-02,2.12708810747923582e-02,3.97277640989341096e-02,1.26223718629946635e+00,5.11558485191595802e-02,3.98302520041591765e-02,8.71159651358681675e-02,4.50522819137725183e-01,4.75948148678106142e-01,9.66914058740716564e-02,2.12772931749612539e-03,4.98537799692975753e-03,5.05688972943828197e-01,
1.27349523924281227e+00,1.06097503288753936e+00,2.85743262512491158e-02,2.42018509890780213e-02,3.99975342775183013e-02,1.27328632503012074e+00,3.15024271478437090e-01,3.57604481819215198e-02,3.70845681131781069e-01,3.06914677542215464e-02,4.74388234144259624e-01,9.59659741309895759e-02,5.57163048068730737e-01,6.32163911416745890e-03,5.20020688893495286e-01,
1.27686416444680262e+00,1.05869775758195050e+00,1.77041489467111776e-02,3.27677149273611218e-02,4.02942921117684094e-02,1.27667156890548261e+00,5.07330123674859107e-02,6.24788510665893160e+00,5.02628447075694051e+00,4.95664969284129842e-01,6.06595769796263035e-02,9.90318639382050669e-02,3.05514498717321262e-03,5.51208210804741139e-01,5.46401945218764062e-01,
1.28193850803312936e+00,1.05977633487097433e+00,2.63584877617301719e-02,3.22935970109836240e-02,4.09639157164984544e-02,1.28128138427770222e+00,9.24858243410800585e-01,9.87042375136761185e-01,5.54814082808959830e-01,3.38779741828767328e-02,6.44015957789563775e-02,9.91134397266291156e-02,5.88848146391747540e-01,5.55349016534359086e-01,5.97417204995949747e-01,

