1
1
15
0
(8 0
((0,0,0) (7,7,7) (0,0,0))
((8,0,0) (15,7,7) (0,0,0))
((0,8,0) (7,15,7) (0,0,0))
((8,8,0) (15,15,7) (0,0,0))
((0,0,8) (7,7,15) (0,0,0))
((8,0,8) (15,7,15) (0,0,0))
((0,8,8) (7,15,15) (0,0,0))
((8,8,8) (15,15,15) (0,0,0))
)
8
FabOnDisk: Cell_D_00000 0
FabOnDisk: Cell_D_00000 61527
FabOnDisk: Cell_D_00000 123055
FabOnDisk: Cell_D_00000 184583
FabOnDisk: Cell_D_00000 246112
FabOnDisk: Cell_D_00000 307640
FabOnDisk: Cell_D_00000 369169
FabOnDisk: Cell_D_00000 430698

8,15
1.23804181015552614e-02,6.43531625325910184e-02,-1.52959575011459466e-02,-1.42843686333071398e-02,-1.19358823909396124e-02,6.32164314092352519e-01,-2.86362708494310994e-03,-1.67201392597063955e-03,-3.14489938617004098e-04,-9.74142330245255164e-03,-3.71589524645205907e-02,-1.35418089305541250e-01,-3.42257757999152812e-01,-3.82100847636200336e-01,-4.46217750982562944e-01,
1.21449316658394663e-02,2.78799220140648549e-02,-1.01874239196253040e-02,-1.47131305720171069e-02,-1.13034191865965285e-02,6.34590824070972337e-01,-7.64089985048466667e-03,-1.88990658699480347e-03,-9.37544261185527749e-04,-3.57837538614593775e-01,-4.95988246242887523e-02,-1.73880306069014084e-01,-9.20247914040920600e-02,-4.43284010610328405e-01,-4.94345965937760590e-01,
1.21497142930699180e-02,9.63183665712972516e-03,-1.34971087247387593e-02,-1.00559434133059619e-02,-1.04675724870052118e-02,6.29698096863227197e-01,-2.51537546296850493e-03,-9.71188191031118961e-03,-2.09248647638464944e-02,-1.73456354688300181e-02,-3.96197672623444852e-01,-2.18988477240675605e-01,-4.17949458167027110e-01,-1.81250837468753145e-01,-5.61886522731749771e-01,
1.21807903369170883e-02,3.08045066457720467e-03,-1.61094054388584498e-02,-1.46747669213035722e-02,-1.30899844212473346e-02,6.27854510862854265e-01,-1.61898130218508657e-02,-1.22670535369688548e-02,-4.83664073344971523e-02,-4.26864985582613654e-01,-4.06062688448198372e-01,-2.72948588042404627e-01,-9.13123369669063406e-02,-1.81565921360911486e-01,-6.05778745470781477e-01,
1.21833533434401835e-02,2.05112041723286070e-03,-1.33703246453499881e-02,-1.46284905618182786e-02,-1.22284809398963031e-02,6.28672711496150560e-01,-2.95695986897684089e-03,-2.73446235138949320e-02,-5.65563434880830829e-03,-2.48959976903931901e-02,-9.33977229575421730e-02,-4.36403307932292039e-01,-5.14309154521046974e-01,-5.18889425621180789e-01,-2.88154158460720622e-01,
1.22141184672203331e-02,3.41024781221610019e-04,-1.44066852266267250e-02,-1.35701096981293134e-02,-1.14718017106561331e-02,6.29512842586520405e-01,-9.16427733078299528e-02,-1.62148035099823756e-01,-1.83045957694195384e-02,-4.59424465274049565e-01,-1.22145406208411633e-01,-4.46269050679330870e-01,-9.27126602478624690e-02,-5.97952785517052887e-01,-2.93334304363203069e-01,
1.23101808846998815e-02,-4.40180867555009308e-04,-1.48055200042064988e-02,-1.15537041597273613e-02,-1.01960298553942091e-02,6.29341824360236446e-01,-7.23304422071449515e+00,-1.05016753341805646e+00,-1.58751399191697812e-01,-4.32231060975192399e-02,-4.85475016674481674e-01,-4.52453521353394117e-01,-5.81573626921732867e-01,-1.86402542671579102e-01,-2.92216065111838508e-01,
1.24098124545182261e-02,-8.29410938872999787e-04,-1.69634803254195624e-02,-1.17836592698399526e-02,-1.43236180518027997e-02,6.29239507386902486e-01,-7.68684759720671129e-02,-2.26366466359523739e-02,-2.35025533241439355e+00,-4.78259557900753418e-01,-5.05695338182928444e-01,-4.99789906639693915e-01,-9.46213930052265950e-02,-1.89019239549008622e-01,-2.93196132822034827e-01,

8,15
7.58142174545380576e-01,1.05504294329405712e+00,1.31041175808823199e-02,1.57419103246752672e-02,1.66103065030866748e-02,1.06742336139561234e+00,9.27335697222750159e-03,1.15853817275721454e-02,9.44340565516942412e-03,3.67306441072710044e-01,4.00717040245391731e-01,4.17651829204474245e-01,1.08054229545154505e-03,4.25969968593886434e-03,2.11566503211199526e-02,
9.22173392918105295e-01,1.05607563963679807e+00,1.85907596873881795e-02,1.95077066510589078e-02,2.05468393758756161e-02,1.06822057130263759e+00,5.03083569873981253e-03,1.60583675769097670e-02,9.86972144700109903e-03,5.86289194491647903e-02,4.24798400771506046e-01,4.59545559947098836e-01,3.38093324154257524e-01,6.02644078296714521e-03,3.06213737390402529e-02,
1.06741404352670921e+00,1.05606342985269741e+00,1.86935777544391078e-02,1.97883352755980069e-02,1.84121529935286389e-02,1.07704588018383896e+00,1.90235897293098699e-02,1.10068277136623309e-02,1.32088067905922479e-02,4.20576899990072806e-01,1.17428490639250982e-01,4.88061540204655309e-01,2.04888484708950352e-03,3.90050851251924346e-01,4.35068595493340593e-02,
1.17804805020662151e+00,1.05565531103674459e+00,1.66507774079893908e-02,2.03268573352173541e-02,2.14086606914253748e-02,1.18112850087119869e+00,1.97373539995839946e-02,1.23197348584533368e-02,1.34117233430484269e-02,5.98213376218150530e-02,1.17537705985414159e-01,4.98850888072666199e-01,4.30881692333799582e-01,4.39685328362776184e-01,6.23457294104067111e-02,
1.20978093920887630e+00,1.05578391949302342e+00,1.77649710158387583e-02,1.62279736200184703e-02,2.15648313937197786e-02,1.21183205962610918e+00,1.98297069559410927e-02,1.38846551209051913e-02,1.15461729732048990e-02,4.64162368065570874e-01,4.67601547426700459e-01,1.85471106175145228e-01,3.02660628666996667e-03,1.26161090412499795e-02,4.63837839381137096e-01,
1.26117838659735382e+00,1.05536083192980512e+00,1.66597092959970376e-02,1.66477041534358917e-02,2.06984724836560656e-02,1.26151941137857548e+00,1.07931229343196738e-01,1.29748614387111827e-02,4.99376540609332009e-02,5.99930638969213281e-02,5.06913376118719117e-01,1.85415567530114178e-01,5.18160499009155173e-01,1.79600208811861867e-02,5.13167559885105873e-01,
1.28278002284858617e+00,1.05449229009353940e+00,1.90641248160643983e-02,2.05384090018222755e-02,2.11105685150431467e-02,1.28233984198103124e+00,5.87992749579395318e-02,3.88356479556282788e-02,9.15422495904546807e+00,4.77584320657894357e-01,1.19277760931715882e-01,1.85338521482990487e-01,5.84432698099093990e-03,5.53069936797901951e-01,5.33792540811290905e-01,
1.29130159918807275e+00,1.05288140948403131e+00,1.81999519731874393e-02,1.94907663715371861e-02,2.15416986474037328e-02,1.29055486218031090e+00,1.13817309268952149e+00,6.13345889879073125e-01,3.15188256492228591e-01,6.03864258987187180e-02,1.20175523712929527e-01,1.87012044590220805e-01,5.60485918405880357e-01,6.09506189979878377e-01,5.84172934639910491e-01,

