1
1
15
0
(8 0
((0,0,0) (7,7,7) (0,0,0))
((8,0,0) (15,7,7) (0,0,0))
((0,8,0) (7,15,7) (0,0,0))
((8,8,0) (15,15,7) (0,0,0))
((0,0,8) (7,7,15) (0,0,0))
((8,0,8) (15,7,15) (0,0,0))
((0,8,8) (7,15,15) (0,0,0))
((8,8,8) (15,15,15) (0,0,0))
)
8
FabOnDisk: Cell_D_00000 0
FabOnDisk: Cell_D_00000 61527
FabOnDisk: Cell_D_00000 123055
FabOnDisk: Cell_D_00000 184583
FabOnDisk: Cell_D_00000 246112
FabOnDisk: Cell_D_00000 307640
FabOnDisk: Cell_D_00000 369169
FabOnDisk: Cell_D_00000 430698

8,15
1.23788876205763280e-02,6.95087667132826686e-02,-1.53042085812088932e-02,-1.40662809128758691e-02,-1.19453247248544146e-02,6.31190886733762779e-01,-2.88212781157802175e-03,-1.74250014733841460e-03,-2.22966359549806004e-04,-9.45617280611314205e-03,-3.76592584895746874e-02,-1.39143222729526339e-01,-3.36810940620200727e-01,-3.76324236956590952e-01,-4.47978921520274964e-01,
1.21436708412458860e-02,3.08466025416852946e-02,-1.00697670522489832e-02,-1.45272246456387092e-02,-1.13571186079918732e-02,6.32797187153801066e-01,-7.21193644776522199e-03,-1.76702498244870492e-03,-6.92651049416608032e-04,-3.56895950637843185e-01,-5.02330985227368992e-02,-1.78470647881177780e-01,-9.19984392870134837e-02,-4.38713356800252585e-01,-4.88007445242369831e-01,
1.21501642918288369e-02,1.04548919140252002e-02,-1.33083213272885015e-02,-1.01816857475030588e-02,-1.05363402855089480e-02,6.29574888126192889e-01,-2.69447858460460056e-03,-9.72823464570604819e-03,-1.86330996313678193e-02,-1.69830458771370388e-02,-3.94180852263049775e-01,-2.25941653110507457e-01,-4.16427330195219381e-01,-1.85264350666525940e-01,-5.60360783757869241e-01,
1.21807842355387223e-02,3.33262698510178096e-03,-1.61768236539366408e-02,-1.49289567835378736e-02,-1.29082565673472646e-02,6.27889469496841990e-01,-1.72700472692835089e-02,-1.29669096355269076e-02,-4.96721946687092020e-02,-4.24290825154159779e-01,-4.04101863951444928e-01,-2.80977014408615111e-01,-9.14306439207825533e-02,-1.84066049687441891e-01,-6.07478674905148397e-01,
1.21803308931676350e-02,2.12003755242671761e-03,-1.33306973285421161e-02,-1.45172256120974751e-02,-1.24387065744654274e-02,6.28716295930680236e-01,-2.92129429409375115e-03,-2.91074783902191235e-02,-5.24076982691938122e-03,-2.46803119566421647e-02,-9.64717326311891887e-02,-4.34711295857097335e-01,-5.12396808418684402e-01,-5.15920642890930647e-01,-2.91734595408431385e-01,
1.22110729893832037e-02,3.82072960461736792e-04,-1.43428874390456092e-02,-1.33836493097783549e-02,-1.15483137637012144e-02,6.29272566424057045e-01,-8.50554856141639004e-02,-1.38744904995425522e-01,-1.84307573538879041e-02,-4.59056900490578124e-01,-1.26026683681115942e-01,-4.43275179231832794e-01,-9.26325094550992795e-02,-5.96261311493194612e-01,-2.97699834296296317e-01,
1.23113264687369842e-02,-4.42249455587924727e-04,-1.49023431467743099e-02,-1.15443699977905469e-02,-1.04957931403515895e-02,6.30077329840077693e-01,-3.59111686856105200e-02,-3.06514327972166357e-02,-1.06124742331221905e-01,-4.32342777900257130e-02,-4.86110017461725052e-01,-4.56582022768549367e-01,-5.81562516309558353e-01,-1.89480623765195061e-01,-2.96865510358856999e-01,
1.24138045718528919e-02,-8.32746974178419884e-04,-1.69780564974204989e-02,-1.18782992780793600e-02,-1.42952135001525558e-02,6.29113080207249542e-01,-5.33420727143897946e-02,-3.84367425027562909e-02,-6.69522450222665100e-01,-4.78379557204381467e-01,-5.04601527352666279e-01,-5.02332605863026083e-01,-9.48113225882462607e-02,-1.92193619749630562e-01,-2.98105119356802561e-01,

8,15
7.40595376719046072e-01,1.05504574076086954e+00,1.30696545922349416e-02,1.59470569758884545e-02,1.64508724648900206e-02,1.06742462838144592e+00,8.83314440493681609e-03,1.11710604064983073e-02,9.33177931625542301e-03,3.65650054622135734e-01,3.98232356044812719e-01,4.12856304180664768e-01,1.04911724455765951e-03,4.32429994329171057e-03,2.20935853180870730e-02,
9.04923096310567665e-01,1.05607889665384125e+00,1.86272766621318406e-02,1.96591656237523268e-02,2.05291537796562784e-02,1.06823109331624511e+00,5.07436113428145260e-03,1.61544993061678265e-02,9.83841977557756153e-03,5.82880775260730261e-02,4.24285883781840956e-01,4.56394340247540664e-01,3.33153353191796120e-01,6.11315359373782678e-03,3.20035100018010582e-02,
1.05777451950715351e+00,1.05606285663686106e+00,1.87258166495096953e-02,1.94316156053160709e-02,1.84163271835273978e-02,1.06822941142117878e+00,1.99956179603611797e-02,1.14385592078896977e-02,1.29983684108362536e-02,4.17671038843123288e-01,1.19647379525701106e-01,4.88253408139999623e-01,2.00354014460493160e-03,3.86329330228547096e-01,4.59871675009065409e-02,
1.17116418025222635e+00,1.05565610039984525e+00,1.64184415847900972e-02,2.00420641420569791e-02,2.14026154508044110e-02,1.17449680723732808e+00,1.95560734607380313e-02,1.36308285060996529e-02,1.33721858713936031e-02,5.97371552294110736e-02,1.19337575583250727e-01,5.01558811032530638e-01,4.25485097453596695e-01,4.35949416329606820e-01,6.59204133917562496e-02,
1.20751564576800874e+00,1.05579302778286954e+00,1.77628026022494528e-02,1.62505141632447239e-02,2.17636287853904820e-02,1.20963568332043536e+00,1.95059088488205891e-02,1.37876989369726775e-02,1.13672437978132902e-02,4.63482711166541939e-01,4.65629256099703182e-01,1.88488651877039892e-01,2.99897907675585398e-03,1.31268211351815017e-02,4.62404062269968996e-01,
1.26010761613002464e+00,1.05537274601745112e+00,1.66053174080425456e-02,1.65779717581201053e-02,2.09282769489971265e-02,1.26048968909048642e+00,1.01707841226838153e-01,1.33787590191018907e-02,4.50519431596497072e-02,6.00846661176739974e-02,5.06118102227276823e-01,1.88672903254268470e-01,5.16570967281980153e-01,1.86943372341289854e-02,5.10350336073006283e-01,
1.28287646139732403e+00,1.05446763856008308e+00,1.91114344726388483e-02,2.02609401393522501e-02,2.13259678852549886e-02,1.28243421194173601e+00,5.80775925902897172e-02,6.50562072164002914e-02,4.32019454881201609e-02,4.77634954407998968e-01,1.21300088882763751e-01,1.88112312131140658e-01,5.84870459332816582e-03,5.55097462858059387e-01,5.29290479593934382e-01,
1.29136837847494945e+00,1.05282732714542515e+00,1.82431943389344334e-02,1.90924064772195305e-02,2.17041738187426260e-02,1.29061634484141408e+00,2.66917353277073999e-01,6.68125581379624967e-01,3.32152264030350031e-01,6.05104268822839741e-02,1.22205411021886284e-01,1.90099658896003609e-01,5.60486269980532414e-01,6.09339047858290739e-01,5.88463650931741022e-01,

