1
1
15
0
(8 0
((0,0,0) (7,7,7) (0,0,0))
((8,0,0) (15,7,7) (0,0,0))
((0,8,0) (7,15,7) (0,0,0))
((8,8,0) (15,15,7) (0,0,0))
((0,0,8) (7,7,15) (0,0,0))
((8,0,8) (15,7,15) (0,0,0))
((0,8,8) (7,15,15) (0,0,0))
((8,8,8) (15,15,15) (0,0,0))
)
8
FabOnDisk: Cell_D_00000 0
FabOnDisk: Cell_D_00000 61527
FabOnDisk: Cell_D_00000 123055
FabOnDisk: Cell_D_00000 184583
FabOnDisk: Cell_D_00000 246112
FabOnDisk: Cell_D_00000 307640
FabOnDisk: Cell_D_00000 369169
FabOnDisk: Cell_D_00000 430698

8,15
1.2378887620576328e-02,6.9508766713282669e-02,-1.5304208581208893e-02,-1.4066280912875869e-02,-1.1945324724854415e-02,6.3119088673376278e-01,-2.8821278115780218e-03,-1.7425001473384146e-03,-2.2296635954980600e-04,-9.4561728061131421e-03,-3.7659258489574687e-02,-1.3914322272952634e-01,-3.3681094062020073e-01,-3.7632423695659095e-01,-4.4797892152027496e-01,
1.2143670841245886e-02,3.0846602541685295e-02,-1.0069767052248983e-02,-1.4527224645638709e-02,-1.1357118607991873e-02,6.3279718715380107e-01,-7.2119364477652220e-03,-1.7670249824487049e-03,-6.9265104941660803e-04,-3.5689595063784318e-01,-5.0233098522736899e-02,-1.7847064788117778e-01,-9.1998439287013484e-02,-4.3871335680025259e-01,-4.8800744524236983e-01,
1.2150164291828837e-02,1.0454891914025200e-02,-1.3308321327288502e-02,-1.0181685747503059e-02,-1.0536340285508948e-02,6.2957488812619289e-01,-2.6944785846046006e-03,-9.7282346457060482e-03,-1.8633099631367819e-02,-1.6983045877137039e-02,-3.9418085226304977e-01,-2.2594165311050746e-01,-4.1642733019521938e-01,-1.8526435066652594e-01,-5.6036078375786924e-01,
1.2180784235538722e-02,3.3326269851017810e-03,-1.6176823653936641e-02,-1.4928956783537874e-02,-1.2908256567347265e-02,6.2788946949684199e-01,-1.7270047269283509e-02,-1.2966909635526908e-02,-4.9672194668709202e-02,-4.2429082515415978e-01,-4.0410186395144493e-01,-2.8097701440861511e-01,-9.1430643920782553e-02,-1.8406604968744189e-01,-6.0747867490514840e-01,
1.2180330893167635e-02,2.1200375524267176e-03,-1.3330697328542116e-02,-1.4517225612097475e-02,-1.2438706574465427e-02,6.2871629593068024e-01,-2.9212942940937511e-03,-2.9107478390219124e-02,-5.2407698269193812e-03,-2.4680311956642165e-02,-9.6471732631189189e-02,-4.3471129585709734e-01,-5.1239680841868440e-01,-5.1592064289093065e-01,-2.9173459540843139e-01,
1.2211072989383204e-02,3.8207296046173679e-04,-1.4342887439045609e-02,-1.3383649309778355e-02,-1.1548313763701214e-02,6.2927256642405704e-01,-8.5055485614163900e-02,-1.3874490499542552e-01,-1.8430757353887904e-02,-4.5905690049057812e-01,-1.2602668368111594e-01,-4.4327517923183279e-01,-9.2632509455099279e-02,-5.9626131149319461e-01,-2.9769983429629632e-01,
1.2311326468736984e-02,-4.4224945558792473e-04,-1.4902343146774310e-02,-1.1544369997790547e-02,-1.0495793140351590e-02,6.3007732984007769e-01,-3.5911168685610520e-02,-3.0651432797216636e-02,-1.0612474233122191e-01,-4.3234277790025713e-02,-4.8611001746172505e-01,-4.5658202276854937e-01,-5.8156251630955835e-01,-1.8948062376519506e-01,-2.9686551035885700e-01,
1.2413804571852892e-02,-8.3274697417841988e-04,-1.6978056497420499e-02,-1.1878299278079360e-02,-1.4295213500152556e-02,6.2911308020724954e-01,-5.3342072714389795e-02,-3.8436742502756291e-02,-6.6952245022266510e-01,-4.7837955720438147e-01,-5.0460152735266628e-01,-5.0233260586302608e-01,-9.4811322588246261e-02,-1.9219361974963056e-01,-2.9810511935680256e-01,

8,15
7.4059537671904607e-01,1.0550457407608695e+00,1.3069654592234942e-02,1.5947056975888454e-02,1.6450872464890021e-02,1.0674246283814459e+00,8.8331444049368161e-03,1.1171060406498307e-02,9.3317793162554230e-03,3.6565005462213573e-01,3.9823235604481272e-01,4.1285630418066477e-01,1.0491172445576595e-03,4.3242999432917106e-03,2.2093585318087073e-02,
9.0492309631056767e-01,1.0560788966538412e+00,1.8627276662131841e-02,1.9659165623752327e-02,2.0529153779656278e-02,1.0682310933162451e+00,5.0743611342814526e-03,1.6154499306167826e-02,9.8384197755775615e-03,5.8288077526073026e-02,4.2428588378184096e-01,4.5639434024754066e-01,3.3315335319179612e-01,6.1131535937378268e-03,3.2003510001801058e-02,
1.0577745195071535e+00,1.0560628566368611e+00,1.8725816649509695e-02,1.9431615605316071e-02,1.8416327183527398e-02,1.0682294114211788e+00,1.9995617960361180e-02,1.1438559207889698e-02,1.2998368410836254e-02,4.1767103884312329e-01,1.1964737952570111e-01,4.8825340813999962e-01,2.0035401446049316e-03,3.8632933022854710e-01,4.5987167500906541e-02,
1.1711641802522264e+00,1.0556561003998453e+00,1.6418441584790097e-02,2.0042064142056979e-02,2.1402615450804411e-02,1.1744968072373281e+00,1.9556073460738031e-02,1.3630828506099653e-02,1.3372185871393603e-02,5.9737155229411074e-02,1.1933757558325073e-01,5.0155881103253064e-01,4.2548509745359669e-01,4.3594941632960682e-01,6.5920413391756250e-02,
1.2075156457680087e+00,1.0557930277828695e+00,1.7762802602249453e-02,1.6250514163244724e-02,2.1763628785390482e-02,1.2096356833204354e+00,1.9505908848820589e-02,1.3787698936972678e-02,1.1367243797813290e-02,4.6348271116654194e-01,4.6562925609970318e-01,1.8848865187703989e-01,2.9989790767558540e-03,1.3126821135181502e-02,4.6240406226996900e-01,
1.2601076161300246e+00,1.0553727460174511e+00,1.6605317408042546e-02,1.6577971758120105e-02,2.0928276948997127e-02,1.2604896890904864e+00,1.0170784122683815e-01,1.3378759019101891e-02,4.5051943159649707e-02,6.0084666117673997e-02,5.0611810222727682e-01,1.8867290325426847e-01,5.1657096728198015e-01,1.8694337234128985e-02,5.1035033607300628e-01,
1.2828764613973240e+00,1.0544676385600831e+00,1.9111434472638848e-02,2.0260940139352250e-02,2.1325967885254989e-02,1.2824342119417360e+00,5.8077592590289717e-02,6.5056207216400291e-02,4.3201945488120161e-02,4.7763495440799897e-01,1.2130008888276375e-01,1.8811231213114066e-01,5.8487045933281658e-03,5.5509746285805939e-01,5.2929047959393438e-01,
1.2913683784749495e+00,1.0528273271454252e+00,1.8243194338934433e-02,1.9092406477219531e-02,2.1704173818742626e-02,1.2906163448414141e+00,2.6691735327707400e-01,6.6812558137962497e-01,3.3215226403035003e-01,6.0510426882283974e-02,1.2220541102188628e-01,1.9009965889600361e-01,5.6048626998053241e-01,6.0933904785829074e-01,5.8846365093174102e-01,

