1
1
15
0
(8 0
((0,0,0) (7,7,7) (0,0,0))
((8,0,0) (15,7,7) (0,0,0))
((0,8,0) (7,15,7) (0,0,0))
((8,8,0) (15,15,7) (0,0,0))
((0,0,8) (7,7,15) (0,0,0))
((8,0,8) (15,7,15) (0,0,0))
((0,8,8) (7,15,15) (0,0,0))
((8,8,8) (15,15,15) (0,0,0))
)
8
FabOnDisk: Cell_D_00000 0
FabOnDisk: Cell_D_00000 61527
FabOnDisk: Cell_D_00000 123055
FabOnDisk: Cell_D_00000 184583
FabOnDisk: Cell_D_00000 246112
FabOnDisk: Cell_D_00000 307640
FabOnDisk: Cell_D_00000 369169
FabOnDisk: Cell_D_00000 430698

8,15
1.23199775651852989e-02,3.41526023689622329e-02,-1.34645391763485202e-02,-1.41546352877021837e-02,-8.45455393524167237e-03,6.27520779030361409e-01,-1.99443099825389681e-03,-6.01181701676008098e-04,5.93409154917680717e-04,-1.00970813133626942e-02,-3.42695621870369865e-02,-1.12559343879386667e-01,-3.71494297813189989e-01,-4.19735477704935633e-01,-4.65539349966184068e-01,
1.20998389376352263e-02,1.41135615411784408e-02,-9.75094556795752868e-03,-1.40005225977957830e-02,-8.22083042459895857e-03,6.27851996000648338e-01,-9.78827629639889701e-03,-5.63575905513781874e-04,-1.19639610019954090e-03,-3.67231189762833865e-01,-4.43740949072774851e-02,-1.41968462853110738e-01,-7.78809833698700382e-02,-4.62975011299873507e-01,-5.24649191747574406e-01,
1.21142857144142316e-02,5.14095495629168179e-03,-1.40497121115734733e-02,-8.82649172493394155e-03,-8.21394667617266969e-03,6.28248294395846507e-01,-1.65016912074207882e-03,-8.32765594415091695e-03,-3.72173524122760280e-02,-1.69077543745272743e-02,-4.10906455044113716e-01,-1.76439937555433357e-01,-4.57572231095424276e-01,-1.63039721047258335e-01,-5.67471916096226825e-01,
1.21418630025163822e-02,1.95667069665186096e-03,-1.36440076589990772e-02,-1.14554337416183320e-02,-1.12565213950055094e-02,6.28010832938655006e-01,-1.82120007076711082e-02,-8.07839922477540662e-03,-4.47311786111384280e-02,-4.39339238006233979e-01,-4.19662095628227316e-01,-2.18215070107019571e-01,-8.21713809751054847e-02,-1.63959656013968280e-01,-5.85166930032558152e-01,
1.21804602079509244e-02,1.54261950185648374e-03,-1.28297600179192103e-02,-1.32613882762387808e-02,-7.76084319049391569e-03,6.29242206570982621e-01,-2.63246294353249640e-03,-2.27284918988380422e-02,-9.00113829565715035e-03,-2.26288503916736716e-02,-7.62426420750131895e-02,-4.47251648677163383e-01,-5.26272309894922241e-01,-5.41483859058437877e-01,-2.60536657737234445e-01,
1.22102270761534938e-02,1.65539691022863390e-04,-1.37695042447542725e-02,-1.25609273518639299e-02,-8.55081229825955733e-03,6.28853862049360446e-01,-1.05317811262520322e-01,-3.38691818789706778e-01,-1.61472366826711164e-02,-4.64404144604891433e-01,-9.74621840663438405e-02,-4.64482396121505547e-01,-8.12540002770439918e-02,-6.02723380669407671e-01,-2.61431731010268509e-01,
1.22877884741365937e-02,-4.15521213212035885e-04,-1.29441136913119887e-02,-9.29633778994570781e-03,-8.22617467663173951e-03,6.28464322134630438e-01,-2.97870878676961409e-02,-1.79966432188210720e-02,-1.15497050896666217e-02,-3.70924366293234123e-02,-4.80598453101845013e-01,-4.67425533274649863e-01,-5.70117379240393296e-01,-1.66943640525269221e-01,-2.62154435224178028e-01,
1.23595193712309655e-02,-7.47328760880167911e-04,-1.50571063170197202e-02,-1.29610493003707132e-02,-1.09270451586530506e-02,6.27629283394974924e-01,-4.69992168690730600e-02,-1.88956713064160758e-02,-3.06020435221340398e-02,-4.69176875111689595e-01,-5.08046811102453089e-01,-4.73348975782305392e-01,-8.46832174008551181e-02,-1.68452887055828976e-01,-2.63644095442966464e-01,

8,15
8.84831476309508091e-01,1.05532818705680009e+00,1.44217656912680216e-02,1.65434646800509538e-02,1.99344357146083798e-02,1.06765144710976001e+00,1.24968473541793267e-02,1.31922431272637804e-02,9.45821599594004296e-03,3.68518283448606376e-01,4.11858649017210088e-01,4.45658740999241854e-01,1.12144627131432182e-03,3.90762235072887511e-03,1.58821180020835076e-02,
1.02141178105805297e+00,1.05626307121465390e+00,1.79541703748833242e-02,1.97853122363892339e-02,2.23122960330809847e-02,1.06837721984222278e+00,6.21838852825966001e-03,1.36524517345519049e-02,1.20188245606500169e-02,5.20126571313407685e-02,4.19667882497560596e-01,4.70332124573160537e-01,3.70200707324755296e-01,5.33478804829802273e-03,2.20496164124353231e-02,
1.13327710505548063e+00,1.05617543720172224e+00,1.79163477971143043e-02,2.32594792692523283e-02,2.08342350222876296e-02,1.13841806001177237e+00,1.59218085673500341e-02,7.64082288114193223e-03,1.45200976681571572e-02,4.40281906055798811e-01,1.04213711400743772e-01,4.80563924991967872e-01,2.01415152535091777e-03,4.18352920772337544e-01,3.01046208948497936e-02,
1.21271201812900342e+00,1.05581799687376243e+00,1.88494444538356912e-02,2.33177353754642006e-02,2.36323818262841739e-02,1.21467137225532573e+00,2.52480061361533802e-02,8.97671335569528300e-03,1.59449514580152669e-02,5.32021464050614692e-02,1.05128962205661147e-01,4.80433857297981659e-01,4.57176860323513623e-01,4.62497368159139999e-01,4.15362946444346459e-02,
1.22757422723060872e+00,1.05575630789591846e+00,1.82215589777338233e-02,1.75207400573944364e-02,2.30348032117518552e-02,1.22911684673246513e+00,2.61464080484120828e-02,1.50705974906633067e-02,2.25025353125432662e-02,4.65113419848232568e-01,4.80843638680410579e-01,1.66125877794599364e-01,2.75893191639726846e-03,9.92700886439150561e-03,4.75742894262558780e-01,
1.26620497756953698e+00,1.05538185989414157e+00,1.82883761247174328e-02,1.95482388457319349e-02,2.31971101343953628e-02,1.26637051726055994e+00,1.92648824930784557e-01,1.64651894573269210e-02,1.16558204253905243e-01,5.32617276590902147e-02,5.07903172669222913e-01,1.66626326483359344e-01,5.26586229310402110e-01,1.35820736629521030e-02,5.28011326130561565e-01,
1.28235481918984218e+00,1.05457843498594017e+00,1.89873797975848996e-02,2.30998640054969825e-02,2.30489076903670452e-02,1.28194457888096336e+00,6.06410188981673509e-02,9.32741402750345006e-02,2.05689029621883568e-01,4.70631807115147738e-01,1.06534596070503043e-01,1.67699032101654738e-01,4.99911890177606906e-03,5.42007170699278396e-01,5.60468488219377559e-01,
1.29063235655280861e+00,1.05337851575500130e+00,1.72062372757627695e-02,2.25594917685076439e-02,2.29591423090198532e-02,1.28997409972439780e+00,3.74566850788554317e+00,4.31123156083191539e+00,1.50167343992155189e+00,5.45086029252186757e-02,1.07736738185825742e-01,1.68349292054497890e-01,5.68840258237822027e-01,6.04065003685619439e-01,5.65908706264877326e-01,

