1
1
15
0
(8 0
((0,0,0) (7,7,7) (0,0,0))
((8,0,0) (15,7,7) (0,0,0))
((0,8,0) (7,15,7) (0,0,0))
((8,8,0) (15,15,7) (0,0,0))
((0,0,8) (7,7,15) (0,0,0))
((8,0,8) (15,7,15) (0,0,0))
((0,8,8) (7,15,15) (0,0,0))
((8,8,8) (15,15,15) (0,0,0))
)
8
FabOnDisk: Cell_D_00000 0
FabOnDisk: Cell_D_00000 61527
FabOnDisk: Cell_D_00000 123055
FabOnDisk: Cell_D_00000 184583
FabOnDisk: Cell_D_00000 246112
FabOnDisk: Cell_D_00000 307640
FabOnDisk: Cell_D_00000 369169
FabOnDisk: Cell_D_00000 430698

8,15
1.23194586119997531e-02,3.67478007852266725e-02,-1.38042098337661460e-02,-1.41431509105163517e-02,-8.53194527517137091e-03,6.27877476234912413e-01,-2.11784545001166046e-03,-5.32123259762423391e-04,7.24589665928648688e-04,-9.80383039340571028e-03,-3.47719333123394647e-02,-1.15674399000087774e-01,-3.67920869657492489e-01,-4.16683383180999956e-01,-4.61152540080666196e-01,
1.20995637482336060e-02,1.54577629510544295e-02,-9.55141958326691937e-03,-1.39735155267087154e-02,-8.32204340810242457e-03,6.28266854463807922e-01,-9.67593768047561587e-03,-6.26310576200065565e-04,-7.50934800702748751e-06,-3.66857769564770397e-01,-4.49513732370844590e-02,-1.45573848957148949e-01,-7.80181351990077432e-02,-4.61491487258827382e-01,-5.21734120909488119e-01,
1.21152692727704136e-02,5.45867679759085445e-03,-1.39711127802068704e-02,-8.75530987850783003e-03,-7.87482928408562988e-03,6.28246509331178093e-01,-1.66577845580602761e-03,-8.53663771405793401e-03,-3.60044548750391574e-02,-1.65496132406532381e-02,-4.09357033692361816e-01,-1.82264725243859227e-01,-4.53855927716306895e-01,-1.65490237189289041e-01,-5.68444458678880604e-01,
1.21424004897517333e-02,2.07847517286175419e-03,-1.39190807063417892e-02,-1.17928296667427924e-02,-1.13155711365567554e-02,6.28023687813393350e-01,-1.73278012495623746e-02,-8.26945747212620361e-03,-4.57001948690363285e-02,-4.37467024001438276e-01,-4.18022920700555745e-01,-2.24747182720866301e-01,-8.16796030782186433e-02,-1.66320822510246713e-01,-5.88687220542799539e-01,
1.21796364590309181e-02,1.57357859992356955e-03,-1.27466567721830921e-02,-1.33239656662688475e-02,-8.00693854497308913e-03,6.29268007802396223e-01,-2.71794021341338577e-03,-2.22518262575358665e-02,-9.02116134251491550e-03,-2.23535342604272436e-02,-7.87186038674484584e-02,-4.46520781170127501e-01,-5.25118030711090977e-01,-5.40088272440433670e-01,-2.64490733735690875e-01,
1.22059727558278836e-02,1.92697868722421393e-04,-1.38108477295078146e-02,-1.25615293357494179e-02,-8.51871706038035727e-03,6.28670790515436062e-01,-1.03434054012637985e-01,-2.88674913396586463e-01,-1.64204080641880065e-02,-4.64210973831540974e-01,-1.00422402307108277e-01,-4.62574242510569666e-01,-8.09350825059147461e-02,-6.02279741704894289e-01,-2.65407204344275338e-01,
1.22879985803905391e-02,-4.14952391850399141e-04,-1.31174027964488637e-02,-9.05486111990277606e-03,-8.14199179460350572e-03,6.28352625846012813e-01,-5.61548264386402401e-02,-1.86529835418815307e-02,-1.10306649363679822e-02,-3.69377135208005525e-02,-4.82130888620993181e-01,-4.64954135566838123e-01,-5.69776120502212713e-01,-1.69909653361606738e-01,-2.66239895242960323e-01,
1.23605098748514435e-02,-7.44751140271169556e-04,-1.58577328153221772e-02,-1.26287694256863176e-02,-1.17881358287260790e-02,6.27785292283200791e-01,-3.60395133009126650e-02,-1.99123809635220646e-02,-3.19855189264494563e-02,-4.69508991860979497e-01,-5.08110273540140156e-01,-4.77405666111869631e-01,-8.42594482701048003e-02,-1.71318503154734236e-01,-2.67731037928633120e-01,

8,15
8.71520483142693037e-01,1.05533379963992346e+00,1.43861589293064543e-02,1.66358803039848777e-02,2.00392129738200531e-02,1.06765489984746287e+00,1.23159135432869982e-02,1.32543331208023508e-02,9.88238883954628382e-03,3.67411143728038569e-01,4.11797710311194776e-01,4.43671016746371549e-01,1.08880668911730434e-03,3.97009668532723094e-03,1.65228489270659168e-02,
1.00932344467856461e+00,1.05626773104132399e+00,1.82673897269207616e-02,1.99773935790014262e-02,2.24318950849304796e-02,1.06838045146926519e+00,5.95697122636485756e-03,1.36848506140326252e-02,1.15058722218034631e-02,5.17669571107014850e-02,4.21396023759854854e-01,4.70037694992447908e-01,3.66845384721628087e-01,5.40894095978781790e-03,2.29116961946792021e-02,
1.12743235366306238e+00,1.05617173432843448e+00,1.81697046249159611e-02,2.31282908135991908e-02,2.09055124948656808e-02,1.13289103046065320e+00,1.59927797148800878e-02,8.37534840076656351e-03,1.45922324883262754e-02,4.38577743340738124e-01,1.05588614963885122e-01,4.82600272950078235e-01,1.96966019626017199e-03,4.15721179325793555e-01,3.17017991314233055e-02,
1.20883625761110580e+00,1.05582177672987654e+00,1.87572242754211332e-02,2.31922511336253405e-02,2.38061873896830284e-02,1.21091473278396755e+00,2.38884796680097870e-02,9.65387731738551538e-03,1.60373349077273866e-02,5.28994627058730973e-02,1.06967430528598875e-01,4.83170701533426172e-01,4.52967369513704643e-01,4.59700077025159193e-01,4.36754142384822991e-02,
1.22638706073089909e+00,1.05575432310942885e+00,1.82035412739484648e-02,1.74066899258247323e-02,2.28660424505059447e-02,1.22796063933082267e+00,2.47746629202749737e-02,1.46416903223940183e-02,2.19861604453392631e-02,4.64697889360703109e-01,4.80058667247014736e-01,1.68393097125657532e-01,2.72439065750092408e-03,1.03060512930479211e-02,4.75368528845026117e-01,
1.26554244241581282e+00,1.05538942137380709e+00,1.81457261995237248e-02,1.93670505585048745e-02,2.29987759238227153e-02,1.26573514028453515e+00,1.80395632316986743e-01,1.62108767733345309e-02,9.97356791662377812e-02,5.30763954332608701e-02,5.08092960503900848e-01,1.68841737726842800e-01,5.25356806836164258e-01,1.40756178760026301e-02,5.26288926595065432e-01,
1.28256695376435426e+00,1.05453786398240124e+00,1.96341248792318221e-02,2.29989283740864268e-02,2.33309265797643148e-02,1.28215200137250385e+00,6.23841512028057571e-02,1.08858664025921661e-01,3.11403665192809265e-01,4.70432441026641890e-01,1.08460715250729714e-01,1.70253429990423311e-01,4.98253374942748701e-03,5.44988887562959268e-01,5.58102704373628744e-01,
1.29122866087260291e+00,1.05332441375769559e+00,1.75239925949747591e-02,2.24486806609492245e-02,2.32160827590570697e-02,1.29049456533869322e+00,9.48856793084693617e-01,1.94939680077373656e+00,2.73206311737598295e-01,5.42013347655126224e-02,1.09601008736426322e-01,1.70903842920386295e-01,5.69385051406588349e-01,6.04941579281373931e-01,5.62153987593726701e-01,

