1
1
15
0
(8 0
((0,0,0) (7,7,7) (0,0,0))
((8,0,0) (15,7,7) (0,0,0))
((0,8,0) (7,15,7) (0,0,0))
((8,8,0) (15,15,7) (0,0,0))
((0,0,8) (7,7,15) (0,0,0))
((8,0,8) (15,7,15) (0,0,0))
((0,8,8) (7,15,15) (0,0,0))
((8,8,8) (15,15,15) (0,0,0))
)
8
FabOnDisk: Cell_D_00000 0
FabOnDisk: Cell_D_00000 61527
FabOnDisk: Cell_D_00000 123055
FabOnDisk: Cell_D_00000 184583
FabOnDisk: Cell_D_00000 246112
FabOnDisk: Cell_D_00000 307640
FabOnDisk: Cell_D_00000 369169
FabOnDisk: Cell_D_00000 430698

8,15
1.2319458611999753e-02,3.6747800785226672e-02,-1.3804209833766146e-02,-1.4143150910516352e-02,-8.5319452751713709e-03,6.2787747623491241e-01,-2.1178454500116605e-03,-5.3212325976242339e-04,7.2458966592864869e-04,-9.8038303934057103e-03,-3.4771933312339465e-02,-1.1567439900008777e-01,-3.6792086965749249e-01,-4.1668338318099996e-01,-4.6115254008066620e-01,
1.2099563748233606e-02,1.5457762951054430e-02,-9.5514195832669194e-03,-1.3973515526708715e-02,-8.3220434081024246e-03,6.2826685446380792e-01,-9.6759376804756159e-03,-6.2631057620006556e-04,-7.5093480070274875e-06,-3.6685776956477040e-01,-4.4951373237084459e-02,-1.4557384895714895e-01,-7.8018135199007743e-02,-4.6149148725882738e-01,-5.2173412090948812e-01,
1.2115269272770414e-02,5.4586767975908545e-03,-1.3971112780206870e-02,-8.7553098785078300e-03,-7.8748292840856299e-03,6.2824650933117809e-01,-1.6657784558060276e-03,-8.5366377140579340e-03,-3.6004454875039157e-02,-1.6549613240653238e-02,-4.0935703369236182e-01,-1.8226472524385923e-01,-4.5385592771630690e-01,-1.6549023718928904e-01,-5.6844445867888060e-01,
1.2142400489751733e-02,2.0784751728617542e-03,-1.3919080706341789e-02,-1.1792829666742792e-02,-1.1315571136556755e-02,6.2802368781339335e-01,-1.7327801249562375e-02,-8.2694574721262036e-03,-4.5700194869036329e-02,-4.3746702400143828e-01,-4.1802292070055574e-01,-2.2474718272086630e-01,-8.1679603078218643e-02,-1.6632082251024671e-01,-5.8868722054279954e-01,
1.2179636459030918e-02,1.5735785999235695e-03,-1.2746656772183092e-02,-1.3323965666268847e-02,-8.0069385449730891e-03,6.2926800780239622e-01,-2.7179402134133858e-03,-2.2251826257535866e-02,-9.0211613425149155e-03,-2.2353534260427244e-02,-7.8718603867448458e-02,-4.4652078117012750e-01,-5.2511803071109098e-01,-5.4008827244043367e-01,-2.6449073373569087e-01,
1.2205972755827884e-02,1.9269786872242139e-04,-1.3810847729507815e-02,-1.2561529335749418e-02,-8.5187170603803573e-03,6.2867079051543606e-01,-1.0343405401263799e-01,-2.8867491339658646e-01,-1.6420408064188007e-02,-4.6421097383154097e-01,-1.0042240230710828e-01,-4.6257424251056967e-01,-8.0935082505914746e-02,-6.0227974170489429e-01,-2.6540720434427534e-01,
1.2287998580390539e-02,-4.1495239185039914e-04,-1.3117402796448864e-02,-9.0548611199027761e-03,-8.1419917946035057e-03,6.2835262584601281e-01,-5.6154826438640240e-02,-1.8652983541881531e-02,-1.1030664936367982e-02,-3.6937713520800552e-02,-4.8213088862099318e-01,-4.6495413556683812e-01,-5.6977612050221271e-01,-1.6990965336160674e-01,-2.6623989524296032e-01,
1.2360509874851443e-02,-7.4475114027116956e-04,-1.5857732815322177e-02,-1.2628769425686318e-02,-1.1788135828726079e-02,6.2778529228320079e-01,-3.6039513300912665e-02,-1.9912380963522065e-02,-3.1985518926449456e-02,-4.6950899186097950e-01,-5.0811027354014016e-01,-4.7740566611186963e-01,-8.4259448270104800e-02,-1.7131850315473424e-01,-2.6773103792863312e-01,

8,15
8.7152048314269304e-01,1.0553337996399235e+00,1.4386158929306454e-02,1.6635880303984878e-02,2.0039212973820053e-02,1.0676548998474629e+00,1.2315913543286998e-02,1.3254333120802351e-02,9.8823888395462838e-03,3.6741114372803857e-01,4.1179771031119478e-01,4.4367101674637155e-01,1.0888066891173043e-03,3.9700966853272309e-03,1.6522848927065917e-02,
1.0093234446785646e+00,1.0562677310413240e+00,1.8267389726920762e-02,1.9977393579001426e-02,2.2431895084930480e-02,1.0683804514692652e+00,5.9569712263648576e-03,1.3684850614032625e-02,1.1505872221803463e-02,5.1766957110701485e-02,4.2139602375985485e-01,4.7003769499244791e-01,3.6684538472162809e-01,5.4089409597878179e-03,2.2911696194679202e-02,
1.1274323536630624e+00,1.0561717343284345e+00,1.8169704624915961e-02,2.3128290813599191e-02,2.0905512494865681e-02,1.1328910304606532e+00,1.5992779714880088e-02,8.3753484007665635e-03,1.4592232488326275e-02,4.3857774334073812e-01,1.0558861496388512e-01,4.8260027295007824e-01,1.9696601962601720e-03,4.1572117932579356e-01,3.1701799131423306e-02,
1.2088362576111058e+00,1.0558217767298765e+00,1.8757224275421133e-02,2.3192251133625340e-02,2.3806187389683028e-02,1.2109147327839676e+00,2.3888479668009787e-02,9.6538773173855154e-03,1.6037334907727387e-02,5.2899462705873097e-02,1.0696743052859888e-01,4.8317070153342617e-01,4.5296736951370464e-01,4.5970007702515919e-01,4.3675414238482299e-02,
1.2263870607308991e+00,1.0557543231094288e+00,1.8203541273948465e-02,1.7406689925824732e-02,2.2866042450505945e-02,1.2279606393308227e+00,2.4774662920274974e-02,1.4641690322394018e-02,2.1986160445339263e-02,4.6469788936070311e-01,4.8005866724701474e-01,1.6839309712565753e-01,2.7243906575009241e-03,1.0306051293047921e-02,4.7536852884502612e-01,
1.2655424424158128e+00,1.0553894213738071e+00,1.8145726199523725e-02,1.9367050558504875e-02,2.2998775923822715e-02,1.2657351402845352e+00,1.8039563231698674e-01,1.6210876773334531e-02,9.9735679166237781e-02,5.3076395433260870e-02,5.0809296050390085e-01,1.6884173772684280e-01,5.2535680683616426e-01,1.4075617876002630e-02,5.2628892659506543e-01,
1.2825669537643543e+00,1.0545378639824012e+00,1.9634124879231822e-02,2.2998928374086427e-02,2.3330926579764315e-02,1.2821520013725038e+00,6.2384151202805757e-02,1.0885866402592166e-01,3.1140366519280926e-01,4.7043244102664189e-01,1.0846071525072971e-01,1.7025342999042331e-01,4.9825337494274870e-03,5.4498888756295927e-01,5.5810270437362874e-01,
1.2912286608726029e+00,1.0533244137576956e+00,1.7523992594974759e-02,2.2448680660949225e-02,2.3216082759057070e-02,1.2904945653386932e+00,9.4885679308469362e-01,1.9493968007737366e+00,2.7320631173759830e-01,5.4201334765512622e-02,1.0960100873642632e-01,1.7090384292038630e-01,5.6938505140658835e-01,6.0494157928137393e-01,5.6215398759372670e-01,

