1
1
15
0
(8 0
((0,0,0) (7,7,7) (0,0,0))
((8,0,0) (15,7,7) (0,0,0))
((0,8,0) (7,15,7) (0,0,0))
((8,8,0) (15,15,7) (0,0,0))
((0,0,8) (7,7,15) (0,0,0))
((8,0,8) (15,7,15) (0,0,0))
((0,8,8) (7,15,15) (0,0,0))
((8,8,8) (15,15,15) (0,0,0))
)
8
FabOnDisk: Cell_D_00000 0
FabOnDisk: Cell_D_00000 61527
FabOnDisk: Cell_D_00000 123055
FabOnDisk: Cell_D_00000 184583
FabOnDisk: Cell_D_00000 246112
FabOnDisk: Cell_D_00000 307640
FabOnDisk: Cell_D_00000 369169
FabOnDisk: Cell_D_00000 430698

8,15
1.23058475987224726e-02,2.50994980854061175e-02,-1.32715654871661173e-02,-1.47042717182581453e-02,-8.44765054045775766e-03,6.28950873092320673e-01,-1.95685673627884896e-03,-3.99792701308401648e-04,1.23147786946594984e-04,-9.87778178021986308e-03,-3.54180338947078024e-02,-9.95303243609528404e-02,-3.79520875873299635e-01,-4.34804441133629593e-01,-4.80249579297741924e-01,
1.20965833226688423e-02,1.01400697032674562e-02,-1.02498738098166231e-02,-1.45596486629521911e-02,-8.52833827783046339e-03,6.28258719204515259e-01,-9.86733130049189527e-03,-8.14579541487317612e-04,-7.95959605659789932e-03,-3.76407278214748842e-01,-4.52590761513540080e-02,-1.24509468288981823e-01,-7.30863745121838326e-02,-4.71038039105398543e-01,-5.30174918966187514e-01,
1.21139784703627774e-02,3.72640443387234127e-03,-1.37488407058612479e-02,-8.08917944641499020e-03,-8.60139473675644410e-03,6.28775366420511350e-01,-1.78227770963276409e-03,-7.78004269678614357e-03,-4.18911484890433922e-02,-1.63408160383953227e-02,-4.16649113358923739e-01,-1.55890595752351591e-01,-4.76484821130881087e-01,-1.59904329644919990e-01,-5.62116821301166469e-01,
1.21359425932182144e-02,1.46726003885781081e-03,-1.22163977189876718e-02,-1.02417823986347516e-02,-1.10300425235873856e-02,6.28068026749433628e-01,-2.52796971497209963e-02,-7.71998569046395983e-03,-3.85221742591294186e-02,-4.45725001653158259e-01,-4.22342942582478842e-01,-1.91668662864799444e-01,-7.61600781149083944e-02,-1.61351025439940177e-01,-5.68486810036692214e-01,
1.21666348753341376e-02,1.39115161411498020e-03,-1.26879272512087169e-02,-1.34386178028380720e-02,-7.32749467713546786e-03,6.28540911717240469e-01,-2.49104306232633081e-03,-2.63474006508314859e-02,-6.70107210259369458e-03,-2.05505872234685860e-02,-7.31243082608794143e-02,-4.48104476290080211e-01,-5.28295097942997449e-01,-5.47525261248206330e-01,-2.43800690215409899e-01,
1.21949291589861786e-02,2.66207272768119135e-05,-1.39097444108418362e-02,-1.27642654889725295e-02,-9.10365598598771378e-03,6.27752334681320967e-01,-1.78146535376590920e-01,-2.34794874999017100e+00,-4.87646465575691454e-02,-4.66689228126850986e-01,-9.21699312473764493e-02,-4.69733636507416397e-01,-7.54096549768031033e-02,-6.04214321640985985e-01,-2.44213016352483603e-01,
1.22696684068149785e-02,-4.03069256937615213e-04,-1.25773648677229080e-02,-1.03289296185857440e-02,-8.36418231911421201e-03,6.27431637867298164e-01,-2.68204742150716657e-02,-1.64514873946802545e-02,-3.13950955093699330e-02,-3.32435956104663033e-02,-4.79353515254790641e-01,-4.77958544158877285e-01,-5.65013464318297354e-01,-1.63196408105573593e-01,-2.44535630252697311e-01,
1.23340205661061995e-02,-7.24887756907102872e-04,-1.60236158999434025e-02,-1.34374224088671737e-02,-1.06975045181580616e-02,6.26431205987445061e-01,-6.71986601264864258e-02,-1.77612901378034621e-02,-2.64575986561513682e-02,-4.72977212183136875e-01,-5.07065476175061147e-01,-4.77559082033325588e-01,-7.82552670463957795e-02,-1.63923384353211327e-01,-2.46068422950393051e-01,

8,15
9.37040320386237635e-01,1.05536589194891617e+00,1.49978040712560427e-02,1.73905124916960904e-02,2.03922528855577795e-02,1.06768345047632196e+00,1.24588125094967882e-02,1.09089507237316551e-02,1.03929566841413912e-02,3.84699943998713378e-01,4.14263974359958986e-01,4.50702483067797366e-01,1.09945538664732553e-03,4.05193375219023606e-03,1.33807219544821252e-02,
1.06220751466200070e+00,1.05627402291719341e+00,1.81009138901298723e-02,1.82217230290424859e-02,2.23724361709796496e-02,1.07234758436526811e+00,6.85427410162231607e-03,1.19018779491121655e-02,1.33428310044630231e-02,4.79290627775586786e-02,4.16356935813711859e-01,4.67249658579898863e-01,3.83457030877126404e-01,5.45874075934663083e-03,1.82263261091093129e-02,
1.16293856917439098e+00,1.05616098449561591e+00,1.68290369282126720e-02,2.28920422581740390e-02,2.12760276052020511e-02,1.16666497360826327e+00,1.52461020691386263e-02,8.45733391142584195e-03,1.40388042316290408e-02,4.47600637259255807e-01,1.02549036156814155e-01,4.70258052378272562e-01,1.95662264585217457e-03,4.34020913833239708e-01,2.48568998569981686e-02,
1.22907903996261725e+00,1.05580916345700149e+00,1.84976261625977370e-02,2.31480083130060910e-02,2.35658113638772121e-02,1.23054630000147514e+00,3.29252041248655203e-02,1.03606632671296821e-02,1.62861664025256980e-02,4.93193488337475006e-02,1.02706477671422949e-01,4.69660995530217562e-01,4.70726132655295948e-01,4.73912982996749499e-01,3.36245764573049125e-02,
1.23211437813139435e+00,1.05578934149591608e+00,1.86841471467013298e-02,1.82114648417232919e-02,2.36779936648832089e-02,1.23350552974550931e+00,3.48284444338459037e-02,1.56887997392618286e-02,2.21236972220758520e-02,4.64016271946109282e-01,4.84103588190944234e-01,1.55571378593108128e-01,2.50396248622844833e-03,9.48009939511732305e-03,4.74006340773851287e-01,
1.26682831092654191e+00,1.05545126767677222e+00,1.79089923155964711e-02,2.09253453058988528e-02,2.35270527666060214e-02,1.26685493165381868e+00,1.15513126363740137e+00,1.70780655949622495e-02,9.96659878620564599e-01,4.91876440865747500e-02,5.08362726001091003e-01,1.55847181944193863e-01,5.27264691794436025e-01,1.27465553563063834e-02,5.28962402749917016e-01,
1.28330816990629959e+00,1.05463603295748731e+00,1.96101915519763560e-02,2.29015284612480025e-02,2.31055678271286091e-02,1.28291170408330069e+00,5.60622045250546569e-02,5.15509443292852809e-02,9.52086693415959001e-02,4.70090717454287432e-01,1.04037237900508922e-01,1.56802720428653564e-01,4.47670377715191168e-03,5.40044824688715952e-01,5.69312758921190265e-01,
1.29074290566668037e+00,1.05356185534877467e+00,1.70602600780115285e-02,2.24118382173224689e-02,2.26652048188280830e-02,1.29003768610730685e+00,2.02195110398957045e-01,3.33007395012175356e-01,2.33577886645723987e-01,5.08034714898710910e-02,1.04876709350939581e-01,1.57333323052303797e-01,5.75209847158615561e-01,6.00689782665737804e-01,5.82031241790636589e-01,

