1
1
15
0
(8 0
((0,0,0) (7,7,7) (0,0,0))
((8,0,0) (15,7,7) (0,0,0))
((0,8,0) (7,15,7) (0,0,0))
((8,8,0) (15,15,7) (0,0,0))
((0,0,8) (7,7,15) (0,0,0))
((8,0,8) (15,7,15) (0,0,0))
((0,8,8) (7,15,15) (0,0,0))
((8,8,8) (15,15,15) (0,0,0))
)
8
FabOnDisk: Cell_D_00000 0
FabOnDisk: Cell_D_00000 61527
FabOnDisk: Cell_D_00000 123055
FabOnDisk: Cell_D_00000 184583
FabOnDisk: Cell_D_00000 246112
FabOnDisk: Cell_D_00000 307640
FabOnDisk: Cell_D_00000 369169
FabOnDisk: Cell_D_00000 430698

8,15
1.23449006396002987e-02,4.89819823045338915e-02,-1.47354641465977359e-02,-1.43105306425769397e-02,-1.00250393810261355e-02,6.32712397862334464e-01,-2.61581141510306607e-03,-1.08236538763034542e-03,4.45793631454917373e-04,-9.66165845812712656e-03,-3.60556939433292270e-02,-1.25790964884850143e-01,-3.56029349162029662e-01,-4.01034227888189432e-01,-4.40528694333543691e-01,
1.21187805041372519e-02,2.10853446610316242e-02,-9.98666087435052391e-03,-1.43431129628851777e-02,-9.63347196878370365e-03,6.31124966861784542e-01,-8.72698587828386538e-03,-1.38041343901689536e-03,-4.04604052564824269e-04,-3.63121556223578612e-01,-4.72329755942625384e-02,-1.59586252807070950e-01,-8.44585570479568504e-02,-4.53491657932970305e-01,-5.09269260960946157e-01,
1.21271517597262013e-02,7.16833924481618742e-03,-1.36545625513813627e-02,-9.38064243780097756e-03,-8.40572426723588950e-03,6.28619916392263667e-01,-2.00745332023009176e-03,-9.32153732394407075e-03,-2.95565314677338313e-02,-1.67585318908350933e-02,-4.02966089431891938e-01,-2.00934210689697967e-01,-4.36861108468032500e-01,-1.72582131227056373e-01,-5.67523274816726264e-01,
1.21571693738513759e-02,2.53180055567774802e-03,-1.51145385949483339e-02,-1.32973396675644170e-02,-1.21260021959895114e-02,6.27931789074762547e-01,-1.51514216652106990e-02,-1.01564794583506469e-02,-4.68208283551920651e-02,-4.32014349221691962e-01,-4.12085811860522233e-01,-2.48691564787917818e-01,-8.58636088871179842e-02,-1.74119304287729759e-01,-5.98846993075288436e-01,
1.21792121341553084e-02,1.71934050087225944e-03,-1.30895578486388223e-02,-1.39879483792002546e-02,-9.93866176174258188e-03,6.28852059470909497e-01,-2.88653164845050717e-03,-4.09904591308227900e-02,-6.44075697239027654e-03,-2.33705109900199277e-02,-8.61073487886280797e-02,-4.42137520647558180e-01,-5.20564959159210972e-01,-5.30932527336003046e-01,-2.77526871823799315e-01,
1.22064769054633111e-02,2.62711158523508122e-04,-1.40649653041194662e-02,-1.31313848113790380e-02,-9.80094650607396881e-03,6.28964379326054868e-01,-9.78943225380705800e-02,-2.23550074340136462e-01,-2.37157953643251200e-02,-4.62139125933086536e-01,-1.10942142728730792e-01,-4.55024497930735905e-01,-8.60865477712814131e-02,-6.00742337028330464e-01,-2.80044540885957538e-01,
1.22974207709708912e-02,-4.54888732653740654e-04,-1.39857279196460189e-02,-9.82069456752101763e-03,-8.72781970341999364e-03,6.27703829874107555e-01,-2.66784630282306701e-01,-2.16142884544528804e-02,-1.37704010378789134e-02,-3.95893116502368039e-02,-4.84614503102214544e-01,-4.55104043731627494e-01,-5.75364484384860431e-01,-1.78420383665430587e-01,-2.79608986353516553e-01,
1.23799558790775501e-02,-7.95154629001812397e-04,-1.64491587834815108e-02,-1.15562584808810813e-02,-1.30023959052844064e-02,6.27462717817273363e-01,-2.64603240899238523e+00,-2.23540844705414944e-02,-6.43080503011229609e+00,-4.71731067610978549e-01,-5.07695456299841918e-01,-4.90163743874961977e-01,-8.82885728435393591e-02,-1.80213964189870457e-01,-2.80829788076614240e-01,

8,15
8.16470661442897372e-01,1.05520846938606638e+00,1.38851129067487714e-02,1.61974223149729327e-02,1.85955168540450633e-02,1.06755337002566675e+00,1.08569629978064255e-02,1.24310756361898610e-02,9.00873749334188227e-03,3.68308422810487368e-01,4.07975045385195911e-01,4.32564126781807501e-01,1.07259567443783455e-03,4.12176521747282566e-03,1.87861950685631676e-02,
9.66017401792630404e-01,1.05616451751508755e+00,1.87134561849672393e-02,1.99265914433234548e-02,2.16969239667828100e-02,1.06829563194217791e+00,5.75373754724915060e-03,1.49896651613514557e-02,1.06034553782299555e-02,5.47073268570433258e-02,4.24387190528528191e-01,4.66231178319031492e-01,3.52957937676952993e-01,5.70316281752998068e-03,2.65340298974680727e-02,
1.09978053758985972e+00,1.05613019981426204e+00,1.87185908337207003e-02,2.17297959204764274e-02,1.96503316400903245e-02,1.10694887683467580e+00,1.67112331024186246e-02,9.87933615325090053e-03,1.41601618683309567e-02,4.30670124952339028e-01,1.10344612634162925e-01,4.87172675348336137e-01,1.98721782999983785e-03,4.03430309645866736e-01,3.73538383471510027e-02,
1.19396854460344803e+00,1.05575588569993584e+00,1.78498246247625544e-02,2.19419376878984343e-02,2.27747115919843188e-02,1.19650034515912584e+00,2.02888489254854296e-02,1.10556451515867443e-02,1.49119767072476671e-02,5.57417505245171932e-02,1.12691643837041888e-01,4.91151194221025711e-01,4.41465802579726285e-01,4.49543491392170425e-01,5.23285838266815267e-02,
1.21929366916939741e+00,1.05570959486791160e+00,1.80309194648234292e-02,1.65684911615936008e-02,2.23601718020148693e-02,1.22101300967026960e+00,2.15130387030190509e-02,1.39881189184382655e-02,3.00495149010257950e-02,4.64796852906910918e-01,4.74858023974286114e-01,1.76260063853103555e-01,2.84699919246022464e-03,1.14408403224954408e-02,4.70673505099803879e-01,
1.26351206468136046e+00,1.05532177517169790e+00,1.73004911950992608e-02,1.73449690117774211e-02,2.19240944536685557e-02,1.26377477583988407e+00,8.90006195438722142e-02,1.45880565796628961e-02,6.89441785284638370e-02,5.60674920477953059e-02,5.07993526170699150e-01,1.76567567991013030e-01,5.21961108864735679e-01,1.58918596159727601e-02,5.20441597537938394e-01,
1.28247975483741272e+00,1.05445661420091774e+00,1.94694269086710531e-02,2.19691826527833936e-02,2.25183349484200900e-02,1.28205700780265430e+00,4.70941137368368068e-02,4.50670432404855603e-01,1.09704053229748810e+00,4.73129864188535865e-01,1.13997488764486204e-01,1.78330064380706199e-01,5.34983401464281770e-03,5.50361739862672117e-01,5.47012435539198205e-01,
1.29147032332325318e+00,1.05306615310732798e+00,1.80798805119606124e-02,2.12437661332019710e-02,2.26124503648742203e-02,1.29067516869425147e+00,6.19838065469047983e+00,2.86628387419543484e+00,2.47369457593821118e-01,5.69051739328558931e-02,1.14994145900708694e-01,1.79201511648747008e-01,5.65617695349308391e-01,6.08247909762563044e-01,5.68456852225746601e-01,

