1
1
15
0
(8 0
((0,0,0) (7,7,7) (0,0,0))
((8,0,0) (15,7,7) (0,0,0))
((0,8,0) (7,15,7) (0,0,0))
((8,8,0) (15,15,7) (0,0,0))
((0,0,8) (7,7,15) (0,0,0))
((8,0,8) (15,7,15) (0,0,0))
((0,8,8) (7,15,15) (0,0,0))
((8,8,8) (15,15,15) (0,0,0))
)
8
FabOnDisk: Cell_D_00000 0
FabOnDisk: Cell_D_00000 61527
FabOnDisk: Cell_D_00000 123055
FabOnDisk: Cell_D_00000 184583
FabOnDisk: Cell_D_00000 246112
FabOnDisk: Cell_D_00000 307640
FabOnDisk: Cell_D_00000 369169
FabOnDisk: Cell_D_00000 430698

8,15
1.23450032595165283e-02,4.54025054987888255e-02,-1.49657717469605465e-02,-1.47093164128221897e-02,-1.04005182757330727e-02,6.31152460928209313e-01,-2.68811337668658969e-03,-1.10411158860880890e-03,3.89984511827758953e-05,-9.88031503418995705e-03,-3.54264015952677758e-02,-1.22012245858750840e-01,-3.60471389990764446e-01,-4.05362105879629731e-01,-4.46250880103393421e-01,
1.21168375969223589e-02,1.90016003721639876e-02,-1.01305097449951639e-02,-1.44525158980889721e-02,-9.63952257877545050e-03,6.29657237671471304e-01,-8.17928647685793250e-03,-1.46066427793456856e-03,-7.21551952546520790e-04,-3.63523378812728559e-01,-4.65932334448052946e-02,-1.55016752793438406e-01,-8.45327579476274904e-02,-4.56448354483620977e-01,-5.13920332409282699e-01,
1.21204504557417495e-02,6.62820876291607148e-03,-1.39911605952632023e-02,-9.56961220362251980e-03,-8.82206161290407728e-03,6.28553574019298678e-01,-1.99932944214849815e-03,-8.39801566940525518e-03,-3.23050179636909796e-02,-1.70944271067533689e-02,-4.04783400285433914e-01,-1.94181662156398899e-01,-4.41463758170711595e-01,-1.70458604960178173e-01,-5.67700949379859043e-01,
1.21509405057690211e-02,2.23691120459127259e-03,-1.50776180444957119e-02,-1.30792894452693622e-02,-1.29595695046365311e-02,6.27849020495184540e-01,-2.33139308683279062e-02,-1.13118155049955881e-02,-3.75698495578766500e-02,-4.34278368974853113e-01,-4.13967502530322884e-01,-2.40792148549973772e-01,-8.66393043872014657e-02,-1.71834829108490239e-01,-5.96296969949677624e-01,
1.21805534770709385e-02,1.77739002415096031e-03,-1.30530798961379473e-02,-1.40357775182825967e-02,-9.94589354644094190e-03,6.28972678024797061e-01,-9.21396281834218830e-03,-4.51303169936538781e-02,-9.23593049088983556e-03,-2.34705429418304093e-02,-8.33015929593700633e-02,-4.43387645275525044e-01,-5.22236909270340055e-01,-5.33159705732811684e-01,-2.73715897755408222e-01,
1.22019823916116651e-02,2.43197786394083108e-04,-1.41406382511568250e-02,-1.30340193049465307e-02,-9.92404207163165124e-03,6.28712462460336630e-01,-1.09972089026717124e-01,-3.92542012577415056e-01,-8.19528514606382430e-02,-4.62626461793239852e-01,-1.07549652927543732e-01,-4.57599827277989757e-01,-8.64203291691229003e-02,-6.01799382295743257e-01,-2.75477514102429821e-01,
1.22936674507394938e-02,-4.66954517059869044e-04,-1.41156191496698870e-02,-9.74510041317406747e-03,-9.10237068087658453e-03,6.27848787495893346e-01,-1.02290448268686135e-01,-2.07828403017115484e-02,-1.00097789127313958e-01,-3.94532830848451158e-02,-4.83526593490262002e-01,-4.58296476385428808e-01,-5.75668875103211297e-01,-1.75330958998680120e-01,-2.75460061442528270e-01,
1.23742886536014167e-02,-1.65759257864632383e-03,-1.60408102621353021e-02,-1.21559489123627268e-02,-1.27197754705452321e-02,6.27272263510044170e-01,-4.18753331599404754e-01,-1.10759531544703152e-01,-1.30893888215471410e+00,-4.71438561892395858e-01,-5.08079311685186941e-01,-4.86147560939992840e-01,-8.82120050469547695e-02,-1.77046109404656177e-01,-2.76120953085383092e-01,

8,15
8.31954430796843836e-01,1.05500164756117520e+00,1.38180411418071664e-02,1.57052035464531649e-02,1.85940050257630343e-02,1.06734692025066047e+00,1.09924862801240759e-02,1.16243692954338465e-02,8.92202290649870416e-03,3.69088399690132185e-01,4.08924313940336959e-01,4.35583128857432111e-01,1.10854542275561942e-03,4.06507210738285205e-03,1.80006459026000043e-02,
9.80781896338375980e-01,1.05613164835103412e+00,1.84595767229648842e-02,1.98218177412043360e-02,2.17565355345434204e-02,1.06826529727337571e+00,5.89617353997965842e-03,1.75893451949366494e-02,1.10252379206715080e-02,5.52321456721785453e-02,4.23535949722093907e-01,4.67647373513102482e-01,3.57144690198722359e-01,5.63408858468855429e-03,2.53666168550610721e-02,
1.10759788918372393e+00,1.05621126214353467e+00,1.86832985048046019e-02,2.22047999030954325e-02,1.96955537691663844e-02,1.11422609794664007e+00,1.75353727682103153e-02,9.35870027623559447e-03,1.33667161277140605e-02,4.32823232146227643e-01,1.08301969638580464e-01,4.85736827110745673e-01,2.03422503964873413e-03,4.06655769767526876e-01,3.53409314201470204e-02,
1.19999175468130614e+00,1.05573608526570473e+00,1.79187161132395786e-02,2.20854346772460519e-02,2.28386271905528793e-02,1.20222866588589739e+00,3.07820143773260523e-02,1.55983767288969156e-02,1.48716130058983639e-02,5.61648327271012729e-02,1.11007057191992456e-01,4.88813765593258565e-01,4.46333284900737148e-01,4.53088962066303780e-01,4.94261821043633365e-02,
1.22147400963302810e+00,1.05571929948375853e+00,1.79688582154053193e-02,1.65931151076142355e-02,2.20815143545489284e-02,1.22325139965717899e+00,2.30352732205207494e-02,1.27931671826305646e-02,3.43812032701689002e-02,4.65259410055546940e-01,4.76115758428316549e-01,1.73184895980944997e-01,2.86493077576343777e-03,1.10334206596936005e-02,4.71704991590263856e-01,
1.26444272777983602e+00,1.05520816680555485e+00,1.73181516951668724e-02,1.75620001390050136e-02,2.16125990668017132e-02,1.26468592556623016e+00,7.35415379874869435e-02,1.60030291782196250e-02,1.33099026432919987e-01,5.59140385288107306e-02,5.08200339004539092e-01,1.74017855748688582e-01,5.23425075573950460e-01,1.53356722294953080e-02,5.22672279396382722e-01,
1.28256832530715226e+00,1.05440326929627837e+00,1.89879944963918280e-02,2.20990555703517652e-02,2.21491516461157431e-02,1.28212596036474658e+00,3.44301858504098113e-01,1.36766804157360222e+00,1.11796152475480404e+00,4.73298030900054068e-01,1.11963558449293177e-01,1.75740385457209408e-01,5.33518896277721151e-03,5.47823615910490558e-01,5.50055256792906455e-01,
1.29149224322662559e+00,1.05301176785894923e+00,1.78698828520522934e-02,2.13887535967634788e-02,2.23590956281286626e-02,1.29068881488062770e+00,3.71203227450991768e-01,7.29172310590973760e-01,1.08495386611735700e+00,5.68079193695139317e-02,1.13061098389104345e-01,1.76093482701336984e-01,5.65604647234391744e-01,6.07625890700655202e-01,5.62682686145065114e-01,

