1
1
15
0
(8 0
((0,0,0) (7,7,7) (0,0,0))
((8,0,0) (15,7,7) (0,0,0))
((0,8,0) (7,15,7) (0,0,0))
((8,8,0) (15,15,7) (0,0,0))
((0,0,8) (7,7,15) (0,0,0))
((8,0,8) (15,7,15) (0,0,0))
((0,8,8) (7,15,15) (0,0,0))
((8,8,8) (15,15,15) (0,0,0))
)
8
FabOnDisk: Cell_D_00000 0
FabOnDisk: Cell_D_00000 61527
FabOnDisk: Cell_D_00000 123055
FabOnDisk: Cell_D_00000 184583
FabOnDisk: Cell_D_00000 246112
FabOnDisk: Cell_D_00000 307640
FabOnDisk: Cell_D_00000 369169
FabOnDisk: Cell_D_00000 430698

8,15
1.2344900639600299e-02,4.8981982304533891e-02,-1.4735464146597736e-02,-1.4310530642576940e-02,-1.0025039381026135e-02,6.3271239786233446e-01,-2.6158114151030661e-03,-1.0823653876303454e-03,4.4579363145491737e-04,-9.6616584581271266e-03,-3.6055693943329227e-02,-1.2579096488485014e-01,-3.5602934916202966e-01,-4.0103422788818943e-01,-4.4052869433354369e-01,
1.2118780504137252e-02,2.1085344661031624e-02,-9.9866608743505239e-03,-1.4343112962885178e-02,-9.6334719687837037e-03,6.3112496686178454e-01,-8.7269858782838654e-03,-1.3804134390168954e-03,-4.0460405256482427e-04,-3.6312155622357861e-01,-4.7232975594262538e-02,-1.5958625280707095e-01,-8.4458557047956850e-02,-4.5349165793297030e-01,-5.0926926096094616e-01,
1.2127151759726201e-02,7.1683392448161874e-03,-1.3654562551381363e-02,-9.3806424378009776e-03,-8.4057242672358895e-03,6.2861991639226367e-01,-2.0074533202300918e-03,-9.3215373239440708e-03,-2.9556531467733831e-02,-1.6758531890835093e-02,-4.0296608943189194e-01,-2.0093421068969797e-01,-4.3686110846803250e-01,-1.7258213122705637e-01,-5.6752327481672626e-01,
1.2157169373851376e-02,2.5318005556777480e-03,-1.5114538594948334e-02,-1.3297339667564417e-02,-1.2126002195989511e-02,6.2793178907476255e-01,-1.5151421665210699e-02,-1.0156479458350647e-02,-4.6820828355192065e-02,-4.3201434922169196e-01,-4.1208581186052223e-01,-2.4869156478791782e-01,-8.5863608887117984e-02,-1.7411930428772976e-01,-5.9884699307528844e-01,
1.2179212134155308e-02,1.7193405008722594e-03,-1.3089557848638822e-02,-1.3987948379200255e-02,-9.9386617617425819e-03,6.2885205947090950e-01,-2.8865316484505072e-03,-4.0990459130822790e-02,-6.4407569723902765e-03,-2.3370510990019928e-02,-8.6107348788628080e-02,-4.4213752064755818e-01,-5.2056495915921097e-01,-5.3093252733600305e-01,-2.7752687182379931e-01,
1.2206476905463311e-02,2.6271115852350812e-04,-1.4064965304119466e-02,-1.3131384811379038e-02,-9.8009465060739688e-03,6.2896437932605487e-01,-9.7894322538070580e-02,-2.2355007434013646e-01,-2.3715795364325120e-02,-4.6213912593308654e-01,-1.1094214272873079e-01,-4.5502449793073591e-01,-8.6086547771281413e-02,-6.0074233702833046e-01,-2.8004454088595754e-01,
1.2297420770970891e-02,-4.5488873265374065e-04,-1.3985727919646019e-02,-9.8206945675210176e-03,-8.7278197034199936e-03,6.2770382987410756e-01,-2.6678463028230670e-01,-2.1614288454452880e-02,-1.3770401037878913e-02,-3.9589311650236804e-02,-4.8461450310221454e-01,-4.5510404373162749e-01,-5.7536448438486043e-01,-1.7842038366543059e-01,-2.7960898635351655e-01,
1.2379955879077550e-02,-7.9515462900181240e-04,-1.6449158783481511e-02,-1.1556258480881081e-02,-1.3002395905284406e-02,6.2746271781727336e-01,-2.6460324089923852e+00,-2.2354084470541494e-02,-6.4308050301122961e+00,-4.7173106761097855e-01,-5.0769545629984192e-01,-4.9016374387496198e-01,-8.8288572843539359e-02,-1.8021396418987046e-01,-2.8082978807661424e-01,

8,15
8.1647066144289737e-01,1.0552084693860664e+00,1.3885112906748771e-02,1.6197422314972933e-02,1.8595516854045063e-02,1.0675533700256667e+00,1.0856962997806426e-02,1.2431075636189861e-02,9.0087374933418823e-03,3.6830842281048737e-01,4.0797504538519591e-01,4.3256412678180750e-01,1.0725956744378345e-03,4.1217652174728257e-03,1.8786195068563168e-02,
9.6601740179263040e-01,1.0561645175150876e+00,1.8713456184967239e-02,1.9926591443323455e-02,2.1696923966782810e-02,1.0682956319421779e+00,5.7537375472491506e-03,1.4989665161351456e-02,1.0603455378229956e-02,5.4707326857043326e-02,4.2438719052852819e-01,4.6623117831903149e-01,3.5295793767695299e-01,5.7031628175299807e-03,2.6534029897468073e-02,
1.0997805375898597e+00,1.0561301998142620e+00,1.8718590833720700e-02,2.1729795920476427e-02,1.9650331640090325e-02,1.1069488768346758e+00,1.6711233102418625e-02,9.8793361532509005e-03,1.4160161868330957e-02,4.3067012495233903e-01,1.1034461263416293e-01,4.8717267534833614e-01,1.9872178299998378e-03,4.0343030964586674e-01,3.7353838347151003e-02,
1.1939685446034480e+00,1.0557558856999358e+00,1.7849824624762554e-02,2.1941937687898434e-02,2.2774711591984319e-02,1.1965003451591258e+00,2.0288848925485430e-02,1.1055645151586744e-02,1.4911976707247667e-02,5.5741750524517193e-02,1.1269164383704189e-01,4.9115119422102571e-01,4.4146580257972629e-01,4.4954349139217042e-01,5.2328583826681527e-02,
1.2192936691693974e+00,1.0557095948679116e+00,1.8030919464823429e-02,1.6568491161593601e-02,2.2360171802014869e-02,1.2210130096702696e+00,2.1513038703019051e-02,1.3988118918438265e-02,3.0049514901025795e-02,4.6479685290691092e-01,4.7485802397428611e-01,1.7626006385310355e-01,2.8469991924602246e-03,1.1440840322495441e-02,4.7067350509980388e-01,
1.2635120646813605e+00,1.0553217751716979e+00,1.7300491195099261e-02,1.7344969011777421e-02,2.1924094453668556e-02,1.2637747758398841e+00,8.9000619543872214e-02,1.4588056579662896e-02,6.8944178528463837e-02,5.6067492047795306e-02,5.0799352617069915e-01,1.7656756799101303e-01,5.2196110886473568e-01,1.5891859615972760e-02,5.2044159753793839e-01,
1.2824797548374127e+00,1.0544566142009177e+00,1.9469426908671053e-02,2.1969182652783394e-02,2.2518334948420090e-02,1.2820570078026543e+00,4.7094113736836807e-02,4.5067043240485560e-01,1.0970405322974881e+00,4.7312986418853586e-01,1.1399748876448620e-01,1.7833006438070620e-01,5.3498340146428177e-03,5.5036173986267212e-01,5.4701243553919821e-01,
1.2914703233232532e+00,1.0530661531073280e+00,1.8079880511960612e-02,2.1243766133201971e-02,2.2612450364874220e-02,1.2906751686942515e+00,6.1983806546904798e+00,2.8662838741954348e+00,2.4736945759382112e-01,5.6905173932855893e-02,1.1499414590070869e-01,1.7920151164874701e-01,5.6561769534930839e-01,6.0824790976256304e-01,5.6845685222574660e-01,

