1
1
15
0
(8 0
((0,0,0) (7,7,7) (0,0,0))
((8,0,0) (15,7,7) (0,0,0))
((0,8,0) (7,15,7) (0,0,0))
((8,8,0) (15,15,7) (0,0,0))
((0,0,8) (7,7,15) (0,0,0))
((8,0,8) (15,7,15) (0,0,0))
((0,8,8) (7,15,15) (0,0,0))
((8,8,8) (15,15,15) (0,0,0))
)
8
FabOnDisk: Cell_D_00000 0
FabOnDisk: Cell_D_00000 61527
FabOnDisk: Cell_D_00000 123055
FabOnDisk: Cell_D_00000 184583
FabOnDisk: Cell_D_00000 246112
FabOnDisk: Cell_D_00000 307640
FabOnDisk: Cell_D_00000 369169
FabOnDisk: Cell_D_00000 430698

8,15
1.22947014760261403e-02,2.22756245372589985e-02,-1.35182578493946888e-02,-1.44618225538548553e-02,-8.43109863273117446e-03,6.28686621325269646e-01,-2.00431074003692847e-03,-2.89840025200584109e-04,3.37575310467547944e-04,-9.90536147233124845e-03,-3.48115820578204921e-02,-9.61374304665056495e-02,-3.82223445298154552e-01,-4.38584610392086127e-01,-4.85482836530122364e-01,
1.20897996619937081e-02,8.92124046500448499e-03,-1.01610766128535888e-02,-1.43271099427501030e-02,-8.01336241759176629e-03,6.28962966026770598e-01,-9.82369776165791658e-03,-9.31274500943015966e-04,-1.07823328228718179e-02,-3.80204812966051853e-01,-4.43737214788794479e-02,-1.20101757543521273e-01,-7.18245147079738661e-02,-4.71855348901287164e-01,-5.32141257737095197e-01,
1.21100763571814311e-02,3.40417535276495153e-03,-1.37431829374160090e-02,-7.63082665714167729e-03,-8.40952671400215304e-03,6.29047310901132972e-01,-1.85263671126380215e-03,-7.15245881310876391e-03,-4.21215565014750465e-02,-1.62089044622387886e-02,-4.18967030335678114e-01,-1.49598601207175941e-01,-4.81479042988592065e-01,-1.56257794506970638e-01,-5.59528908307979522e-01,
1.21294379194270031e-02,1.33703875636077265e-03,-1.24560637291094012e-02,-9.55727947628803864e-03,-1.06272899701682425e-02,6.28080274307716291e-01,-2.85427688046613302e-02,-7.26721472432213800e-03,-3.59754770852281081e-02,-4.47485114723987332e-01,-4.24636492407669652e-01,-1.83866770044507577e-01,-7.45094462184667794e-02,-1.57926722062233349e-01,-5.63984978744237253e-01,
1.21579808779282914e-02,1.28305302071175017e-03,-1.23516558485794719e-02,-1.30507274599220985e-02,-6.96269846392495381e-03,6.28563572792406156e-01,-2.70907867104260708e-03,-2.59620648844561229e-02,-6.67176830945936591e-03,-2.02950193769966605e-02,-7.08994104644705275e-02,-4.48750035640836820e-01,-5.30594258434500032e-01,-5.51994441569643168e-01,-2.38739332134219523e-01,
1.21865505593771930e-02,3.02967775534238481e-05,-1.40423629787118052e-02,-1.22976323255931646e-02,-9.11935627360189842e-03,6.27647466603890813e-01,-3.95007616658359595e-01,-2.42341850424821548e+00,-5.86338268642490751e-02,-4.67811306336703203e-01,-8.91630366559727633e-02,-4.71388404806531991e-01,-7.35328672187801347e-02,-6.05884112730812330e-01,-2.39272752672577443e-01,
1.22574228720697450e-02,-4.03636696406138563e-04,-1.26005267643870805e-02,-1.05697249151390227e-02,-7.90439019929772141e-03,6.27127604303507225e-01,-3.81994031087732056e-02,-1.58962449849610089e-02,-7.17271660324443616e-02,-3.24898323415446569e-02,-4.78673075229325118e-01,-4.81170358274680521e-01,-5.63370509036552281e-01,-1.59764260414114873e-01,-2.39497657048232393e-01,
1.23188647648841444e-02,-7.41631991737838636e-04,-1.64954453328625093e-02,-1.38906142963907842e-02,-1.04055052925031907e-02,6.26490407350216216e-01,-6.70251694875530629e-02,-1.77884759490376451e-02,-2.55919118168811688e-02,-4.73928202920541830e-01,-5.07118912472139471e-01,-4.80532766302473047e-01,-7.65248748512870336e-02,-1.60448479881167311e-01,-2.41130303724341744e-01,

8,15
9.55709194701364395e-01,1.05541247002447514e+00,1.50974919982550387e-02,1.78070221363541698e-02,2.08579507909548816e-02,1.06772017262352192e+00,1.27065920441901715e-02,1.01259725607844488e-02,1.10310669472827635e-02,3.90269213760679579e-01,4.13452198979683216e-01,4.52034724233520979e-01,1.10409509905140969e-03,3.98180680824998696e-03,1.27586342256893089e-02,
1.07673021669625690e+00,1.05630780217502096e+00,1.86211003682081287e-02,1.84797082712532534e-02,2.25973381565325419e-02,1.08565145716126144e+00,7.34590414723590088e-03,1.14690170311513781e-02,1.41563298352752939e-02,4.68494173152181892e-02,4.13254353288747822e-01,4.65804835768816372e-01,3.88093788923261629e-01,5.34956157080662340e-03,1.73099794996647641e-02,
1.17072461973455222e+00,1.05615207056652016e+00,1.72267683763114542e-02,2.31447911183846611e-02,2.16817278771132931e-02,1.17412879508731716e+00,1.47250830679171284e-02,8.53053011969149774e-03,1.41579540445978640e-02,4.49266761378083690e-01,1.00310420427790176e-01,4.67288717404241605e-01,1.94411499999479231e-03,4.38347392811596070e-01,2.33662574813379049e-02,
1.23326874135275033e+00,1.05582568185422643e+00,1.86891396630015569e-02,2.33295590336089417e-02,2.39191506255134745e-02,1.23460578010911104e+00,3.68193003787149614e-02,1.12694145174547285e-02,1.67316374881521929e-02,4.82864491313765090e-02,1.00583034040859248e-01,4.75250308509888530e-01,4.74556799177936472e-01,4.77805127153194342e-01,3.14861643682948431e-02,
1.23566972170613876e+00,1.05580434018002056e+00,1.93334529816810777e-02,1.89938606775066701e-02,2.44121677520816385e-02,1.23695277472685050e+00,3.55398994361677614e-02,1.63512526428616876e-02,2.24655075796389575e-02,4.63776892629307158e-01,4.86184707813915207e-01,1.52326409243323996e-01,2.47844206918150988e-03,9.16818617366363040e-03,4.74745446279905670e-01,
1.26862238026388252e+00,1.05545865766860270e+00,1.80744713511939506e-02,2.15658750369011921e-02,2.41997374063873637e-02,1.26865267704143592e+00,1.05315539194859209e+00,1.76605425480571669e-02,8.38108355379978631e-01,4.80651015050509306e-02,5.08404334798520763e-01,1.52760292804654946e-01,5.29721542542140100e-01,1.22836804686837428e-02,5.30278073265538108e-01,
1.28366177488941346e+00,1.05469038413147942e+00,2.01969904691203690e-02,2.30434612815969865e-02,2.33711824643378224e-02,1.28325813819300727e+00,5.91213867991402242e-02,5.46887282805563063e-02,8.20762503609206856e-02,4.72612898280076854e-01,1.01871833487246669e-01,1.53742648796018677e-01,4.38352529733696851e-03,5.39072024318438814e-01,5.71511632617015541e-01,
1.29088028298335611e+00,1.05365172407955532e+00,1.74772079143211585e-02,2.25739611067686807e-02,2.33966359392478382e-02,1.29017416754126146e+00,1.94226556480961599e-01,2.87404042519760039e-01,2.14715072687499897e-01,4.98376261806420251e-02,1.02677784726833102e-01,1.54214195390278280e-01,5.76824110411395252e-01,6.00239669857905001e-01,5.87234761230564395e-01,

