1
1
15
0
(8 0
((0,0,0) (7,7,7) (0,0,0))
((8,0,0) (15,7,7) (0,0,0))
((0,8,0) (7,15,7) (0,0,0))
((8,8,0) (15,15,7) (0,0,0))
((0,0,8) (7,7,15) (0,0,0))
((8,0,8) (15,7,15) (0,0,0))
((0,8,8) (7,15,15) (0,0,0))
((8,8,8) (15,15,15) (0,0,0))
)
8
FabOnDisk: Cell_D_00000 0
FabOnDisk: Cell_D_00000 61527
FabOnDisk: Cell_D_00000 123055
FabOnDisk: Cell_D_00000 184583
FabOnDisk: Cell_D_00000 246112
FabOnDisk: Cell_D_00000 307640
FabOnDisk: Cell_D_00000 369169
FabOnDisk: Cell_D_00000 430698

8,15
1.23749625324524742e-02,5.34383555854571965e-02,-1.55957472355861375e-02,-1.56269762010071769e-02,-1.24071443044816172e-02,6.36007508640136110e-01,-2.70894208673388634e-03,-2.01763415551446147e-03,-6.75734828043357289e-04,-9.62327321812974160e-03,-3.91786426998263076e-02,-1.23683098053529505e-01,-3.51849599878258701e-01,-3.97444436305814108e-01,-4.38289128690780516e-01,
1.21510702833574798e-02,2.30519230640521960e-02,-9.99112573446244920e-03,-1.57394629017277091e-02,-1.19494576970900924e-02,6.32873570845914335e-01,-8.28174515048312257e-03,-1.71356471589956868e-03,-1.48038918760275747e-03,-3.61613779129419444e-01,-5.15518995830330923e-02,-1.57740734035346442e-01,-8.70517954590368653e-02,-4.53629348956202327e-01,-5.02762398348907569e-01,
1.21516445968811136e-02,7.34224529415573347e-03,-1.35694243796618402e-02,-1.02768271961408454e-02,-1.11523095677315345e-02,6.28040392200104658e-01,-2.20722159770104067e-03,-1.05585245146206513e-02,-2.93148117340795156e-02,-1.70921164849995311e-02,-4.00282493987160204e-01,-2.01668152881112311e-01,-4.35324822668968603e-01,-1.79938079412822083e-01,-5.66111197630802976e-01,
1.21807108093992204e-02,2.53008510646550314e-03,-1.56825284186318525e-02,-1.42758208324237097e-02,-1.32869450058991298e-02,6.28058802732324173e-01,-1.53489007371427864e-02,-1.09777486631579164e-02,-4.76551321795133237e-02,-4.32454716172575637e-01,-4.06738323882280817e-01,-2.50472539647932479e-01,-8.80465314338519101e-02,-1.81935177232771667e-01,-5.98486100522226172e-01,
1.21892960300951370e-02,1.99106438935481040e-03,-1.40902780031989250e-02,-1.55001130433225186e-02,-1.18589931455901874e-02,6.28359275869669665e-01,-2.98533287584714377e-03,-2.58597763571088192e-02,-6.42382797858416163e-03,-2.32616957759712931e-02,-9.29534057288536053e-02,-4.39148810182588722e-01,-5.14931758663409012e-01,-5.21279786249723931e-01,-2.76647594437185007e-01,
1.22197729250989005e-02,3.75825574808073902e-04,-1.44475818961926124e-02,-1.47329663565766399e-02,-1.13201303479688840e-02,6.28745909765856092e-01,-8.19021499713817880e-02,-1.41303908499023745e-01,-2.47257664227080731e-02,-4.60641874990100564e-01,-1.20024488753402991e-01,-4.53513650684064740e-01,-8.83815670387083224e-02,-5.96379589236451402e-01,-2.80094014457298979e-01,
1.23164481230267995e-02,-4.17243631317574691e-04,-1.43512039500467529e-02,-1.08632014708433464e-02,-1.01344387233581190e-02,6.28106989735669252e-01,-2.50231384026306847e-01,-6.22240945161524547e-02,-2.02306951476077385e-02,-4.02514322112559469e-02,-4.85849787967249036e-01,-4.54050449232020814e-01,-5.77718538975901308e-01,-1.85792493520855251e-01,-2.79102379366074960e-01,
1.24085240316042112e-02,-7.91820441843000167e-04,-1.68073931363958221e-02,-1.17953334138822651e-02,-1.41822843833250833e-02,6.28607086167102924e-01,-7.15695295030740197e-02,-2.21827708866603468e-02,-9.05754413906417200e-02,-4.72872918324874880e-01,-5.05677344586222821e-01,-4.90403898569563568e-01,-8.98463034614522260e-02,-1.87801233785970467e-01,-2.80118084638861786e-01,

8,15
7.98527096568713457e-01,1.05506088524731290e+00,1.30701103679121446e-02,1.56552642721656289e-02,1.69273442820094613e-02,1.06743584777976541e+00,9.98281790815512375e-03,1.16992172890476448e-02,9.53044358023240855e-03,3.68138903413069096e-01,4.07496189047774071e-01,4.27413563544233099e-01,1.06713495487846619e-03,4.50635879260422468e-03,1.84333407864718975e-02,
9.52882504140988074e-01,1.05605749093020251e+00,1.86234011814266909e-02,1.82178414225229804e-02,2.04366208844461474e-02,1.06821031420881307e+00,5.22411658460352184e-03,1.42001033630387227e-02,9.84022250368021129e-03,5.60566439453933155e-02,4.27257406800628847e-01,4.63004514129211397e-01,3.48529022100561137e-01,6.28121536591401582e-03,2.62126781691930169e-02,
1.09736983755199136e+00,1.05605760689014105e+00,1.83155975608163823e-02,2.04542247676182259e-02,1.80182819350555787e-02,1.10471208284614719e+00,1.54609735721908462e-02,1.07570294151224828e-02,1.33787678922809294e-02,4.29845760981173053e-01,1.15806436555209807e-01,4.86347778925217522e-01,2.02553105343638781e-03,4.02846305576529062e-01,3.77222923057889195e-02,
1.19411212762867258e+00,1.05566279994884193e+00,1.69367546728546106e-02,2.07106733535485504e-02,2.11088329558851776e-02,1.19664221273513816e+00,2.08087205061559290e-02,1.16093220593714991e-02,1.36055583088548725e-02,5.67846648913043345e-02,1.17773018464786175e-01,4.90484499819037190e-01,4.42444703789854676e-01,4.47406769623334810e-01,5.31847810079657812e-02,
1.21174208567272945e+00,1.05574698937978506e+00,1.75492342840587005e-02,1.59496224530762884e-02,2.13289929961393739e-02,1.21373315006208427e+00,1.96894745062324468e-02,1.30250787473952662e-02,1.20757038758420657e-02,4.63502439441049630e-01,4.68952209485282934e-01,1.76683870946967053e-01,2.82322750411991355e-03,1.25397509721604100e-02,4.63633400545100716e-01,
1.26056739114633642e+00,1.05535682712503953e+00,1.72688645793077564e-02,1.64406274655869537e-02,2.07715433740953311e-02,1.26094321672114451e+00,1.01881667698202380e-01,1.29279368526875379e-02,5.16214042344145807e-02,5.70870811208896156e-02,5.06165711046303923e-01,1.76654625441943769e-01,5.17357340632117246e-01,1.75472916416272995e-02,5.15782469601744675e-01,
1.28228092705524133e+00,1.05444678377332579e+00,1.90114031270009302e-02,2.08629708489553381e-02,2.11612259896993699e-02,1.28186368342392365e+00,5.53883073950339061e-02,4.06101849988417390e-02,3.81634563960524975e-01,4.74204772336363267e-01,1.18673339590923715e-01,1.77724862555573238e-01,5.43486436910754593e-03,5.53861492365739005e-01,5.45238441561215259e-01,
1.29146609450914518e+00,1.05295097076084399e+00,1.81442848059783224e-02,2.01787782711026278e-02,2.13153606958757652e-02,1.29067427406730229e+00,1.31160491722900951e-01,1.77785892464572681e+00,7.47889259453095478e-01,5.77413065423150323e-02,1.19629077170062686e-01,1.78605744334839112e-01,5.64316636145238082e-01,6.08192717759468371e-01,5.69162652391730584e-01,

